--X------M-----------X-----------M----------------------------------------------------B---------M---MX------E---------------------------------B----?---------M-X----------------------------------------
---M--X-----------------B---XX---------------X--------------------B----B-------------------------?--B-------M--------------o------------------------M------------------o---X---------------M------------
---------X----------------M-----------M------M-MX--------------------------------------------------------------?----------X---M----------------X------------------M------X----------------X-------------
-----------M--------E--------------------?--X-----------------------------------------------B-------------------X------------------------------B--------------B--------X---------------------o------M---
---X----------X---X-M-------X---X------------B-------------------B-------------------------------oX---------------X------------------B------------------------B-------?---------B--------------M--------
---o-------------------X-M-----------------B--------M----B------------B-----------------------X-----X--------------------oo-----------o-X---B-E-----M-M?-------X----------------------------------------
---------------------------------------B------Bo-o----------------------------X----------?-----M----X-----X------M----------MMB---------------B-----------o-----------------------------X--B------------
---B-----X--------------------B---------------------B--------M--------------M-------------------------B-----o----o--B-----------------------------?X--------------?----X-----------------X----X--B-----v
-------X---------------B--Bo-------------B------------X-----------------------------X---------B----------------------------X-----------------------X-BX----------------------X------Bo-------------E---f
------B---------------------X-------------------------------------------------X---------------------M------------M-----------M---X------------------X--------------------------B-------X----o------B---f
--------------------o-----------B--------X-----------------------------------M--------------------------------------X-----------------M-------------M------M-----------o-B-----------------------------f
--------------------------------------------------------XM----?--------------------------------X---X-o------------------M----------BX-----------------o-------?----------------------------------o-----f
--------X--B-----------------M--X-----M---M-------------------o-------------------X-----o-------X------MX----------------X----------------------------------------------------X----B---B---------X-M---f
--------------E---------------------------B------------X----?----------------------------------M--Xo--X-----------------------X------------------Xo---M---------------M---B----------M-------B-B-------f
m-------------X-------------------o-----------------------------------------------------------------------------------------------------o----------------------o--------------------X------------------X
XX-X-XXXXXXXXXXX-XXXXXXXXXXX-XXXXXXXXXXXXXXXXXXXXX-XXXXXXXXXX-XX-XXX-X-XXXXXXXXXXXXXXXX-XXX-XX-XX--XXXXX---XXXXXXXXX-XXXXX-X--XXXXXXXXXXX-X-XXXXX---XXXX-XXXXXXXXXXXXX-XXX-XXXX-XXX-X-XXXXX-XXXXX---XXXX
