----B-X--------------?----X---X-----B------o-----M---M------------B--X-------------o---?--X-X-M-------------------------E---------X---------B-----------X----------?---------------?-EBM----M--------X--
-B---------------------B----X?E---?-----------M-----------MB---E----?---------X-------B----XM---------BX--------E-------X---X----X-M--X--X-------------M--------------M------------M-B---??----------M--
--------o-----------------B---M-B-?-------------X---X---B--o---B----------------B--M-----X----MX-X-------B--o---?--M-B--------------------B-X------------------------------------X--X---------B---B-B---
---M---X--o-X---------?--------------?-X--------o-M----B-------------M-X------------M--o------------------X-M-----------------?---------------B--?BM-M---------------------X----B----o-M----------------
-------------X---B?------?B-----?------B----X---XM----------X-----------B---X------------E---?----X----------X-X--M---XX-M-----X--X---X--------------------X---M-----X-X---------X-?-------B---B------X-
----X-X---------B-----X-------?--------------X------------------X----------X-----------X-B----M---------?-----M---------B--M-------------------------X----M----o-----------------o-B------------?--?----
-------------o---------B----------------------------X----B-----X------X-------------------M?----------------------X--B----o----------?--X----------------------?B-------------X-----------------X-------
-----------M---XM-M?--------------B--B-M--X---------------------------o---M-----B------B-----------M----M-------------B-----M-------?--------B----MX--?-----M---X-----M------------------X-------------v
---o----?B-------------------------------M---M---o-----------------M------------------X------MB---------M-B--X---?------X--M-?--X-----M------------------o---X------------------------B-X--o---------MBf
-----------B---o--------MB----B-------M-B----M-----?---------?-?X-------------?--------X--o-------B------X-----?-B-MX----X-------------B?-------------?---M------------------?--------------X----------f
---------X-o-B------------B--X------X-?-X-Xo----X-B-X--M----M------------X-------T---------------oX------------------M--E--EB--X--------X-----M-TB------B-----M--X-BX-?---B---M------X----BB-----------f
----------Bo-----------B--------------------Xo--o----M----------X---T--B---------B---M----M-------------Bo--o---o-------B--X-----B-B----------------------X---M-----------------------X--XE------X-----f
-----T-------X---------------M--------M--------X-----T-----?---?-TM----B----X----|----B------B----?----------?-B-----X------------------------B-|--X-X----------------X----M-------B------X--B---B-XX--f
------------X---------M-M----X-----M-----------M------------o--------|----------M|-?-------------------------B---------E------------------------|X------MMo---X------X-X------------X-Xo-Xo---------B--f
m----|-----------------------X-------------------o---|----o----o-|--||---------o------------------o--------------------X-------X----------------|----------------------------------------X----------X--X
XXXX--XXXXXXXXXXXXXXX--XXXXXX-XXXXX-X-XX-X--XX-XX-XX-XXXXXXXX-XXXXXXXX-XX-XXXXXXXXXXXXXXXXXX-XXXXXXX---XXXX--XX-XXXXXX-XX---X-XXX-XXXX-XX-XXX-XXXXXXXX-XXXXXXXX-X-X-XXXXXXX-X-XXX-XXXXXXX-X-X--XXX-XXX-X
