--------?---X-------X---X-----B-----o------------M-----------M--------------o-M------------------------------------?X-----------------------------------------------------------------------------------
-----------B--------M-BM-------------------------------X-B-X------------------B---------B---------o--X-----------X--B-?----------------?------B---?o-------------X-----------------o--BX--o-------------
------------X---M------?------?--M-o---------------------------------------------------------------B-----------------M----?---------------------------------------------M---------X----XM---------------
---oX--------------------------------------------------------X------X--B-----------------B---X-oB---o------B-------M----?-------------------------------X?--------o-------------X-------B---------------
---------------------------------------------------oXM--o-X----M--------------X--------B--------------M-----------------------------X--------------B-----------------------------------B-------------?--
-----------?-----------X-------------X---M-----X--M---E----M-E----B--B--------X-------------------------------------------------?-------X--------------X--------B--M-------------B--------------X-------
-M-------X---X-----MB----------B---X-------X----------X------X---?-----------X---?-------------?-----X----------------B--?--------------------B-X-------------------------------------------------------
--------------?-----------------------B-----------------------------------------------X-------M--------M------------------------------------------X------B--X---------------M---------------?--B-------v
----B--------------?---------------------B-M----------------------B------------------M-------------o------B-o-----------------?--------------------------------------------X-------------------M------?f
--------X-MM---------------------B----------------X--X------X-----X---------------------------o----------------------X---X---o------------------B------E---oX---------B-------X--------------X---------f
---------------------------------M--------------------------o-------X-------X----------X----M------------------------X--------------------------B------X---------------------------------M-------------f
---------M---------------------------X------------B------------------------------------------X-------E--------X-X-B---------?--X-------MM-------------------------T----------------------------X-----B-f
---------------MB-----?-o------X?----X--o----------B-------B--B----------------------B---T-----------X-----M--X--------------o-M--------------?-------------------|----------X----------------?--------f
-------------------------M------B------o---X--------------?-------------------?------X---|------------------------------------------------------------------M-----|-----------------X----X-------------f
mX--------------X------------------------------------------------X------X----------------|------------------------------X-----------------------------------------|------------------------------------X
X-XXXXX-XXXXXXXXXXXXXXXXX-X-X-XXXX-XXX--XXXXXX--XXX-XXXX-XXXXXXXXX-XXXXX-X-XX--XXX-XXXXX-XXXXX-XXXXXXXXX-XX-XXXXXX-XXXXXXXXXXXXX-XXX-XXXXXXXXXXXXXXXX--XX-XXXXXXXXX-XXX-XXX-XXXX-XXXXXX-XXXXXXXX-XXX-XXX
