-X-o------------X-------X-X--------o------o----X------XoX------------------------o--------o-o-o----X---------o--X-----------X----------------------X-------o--------X-----X---------X--------------XX---
---------o-o--------X------oB--X-------X-X-XB---------X----X--o-B--X--------o----oo---o-------------------XM----X---o--------X----X-B--o---------------XX--X---o----X-o-X--X--?---o--o-o----X--------o--
-------------Mo----M-X-o------oX-o------XX-----------X---o--o-----?-X---------oo----E----X-X------X---M------??----o--o---M--------E-----XX-------X----X-----o--X-----oX-?---------X--------X-----------
---M------XX-----X-----o--?-M-----B----M---X--------oXM------------------Bo---------M?-M----Xo--X------o-------X-----------oXX--X--X--X----------o----o--o-----o--o--------------------X--?-------------
-?------------X----X------------X---------------------------X----------o--XX-X-------------X---B---X---oX--------X-X--o--------o----------o----o----oX-M---X-X---oo--XX--B--X-X------oB----X------------
--------X-------------o---X-------M----o---X-------?----X---X----X--X---Bo--------------X---M------X-o----X-----XX-----BX-o--X--B--o-?-------------Xo---------M---X--------------------o----------------
---o-B-?------?--X-o----X----X--------X-M--------o---X---B----B-----o-----------------X-X-------B----o------?--X---o-X-----o-----X-----XB----o--o----o----o--------B--------o--?--oo-----?----XoM--B-X--
--------X---E----X-------o-------EX-----------X----M------M------o?--X----o--oB------------------o-X-----------o----X--X-BM------o-------------XXXo-------o-----Xo---X--X-o-----------------------E--X-v
------X-----X-Xo-----X-------o---Xo---B--BMo---X--------X--X---------------X-------Bo----?-M-X------X----------------------X---o----o----Xo-B-?---XX----o-----X----oX------o--------o-XX-------MXXX---Xf
--X----X---o--------------------o-X-E--------------------o----ooB------o---X-o------X--X----M--------B--EX-------o-X-XX-----B-o----X--------------------------------------------X-o--oX---BX--------o--f
-X------X-B-------o---------oX--XX--X---------X--------------o---X----X--------X----------B----o--------M-----M-oX----o----------X-Xo----------o--?-oX--X---X--X----X-o-X--------------X----o-X-----X--f
-----X-o-----------B-----B--X---oo---o-----X------X----------------XM---X--o--B--------M-------------------------------------------X-X---------------X-?--------------X-----Mo----B-----X---------X-X-?f
----o------X---------M-X---o-----------M-oX-o------o----------X-------XX-o--------o------X--X---X---X-o--------Xo---o----------X--oX-----X---M---MXX---------X--X-X----T------------XoX---o---o--------f
--------B----o----X------X-------X-------------Xo--o-----M--X--o-?B-------------ooX-------B----------------XM-------------BB-Xoo------X----------------oo-X---T-----X?-|-?----X-M--X--X-----X-------o--f
m---------o-------X-------X-------------X----------X--------X------T-----------------o-X----------------X----------o------------------------------------------|--------|------X--X-----X---------------X
X--XX--XXXX-XXXXXXXXXX-XXXXXX-X-XX-XXXX-X-XXXXX-XXXXXXXXXX--XXXXXXX|XX-XXXXX-XX-X-XX-XXXXXX-XXXXX-XXX-XXXX--X-XXX-XXX-X----XXXXXXXXXXXX-X-XXXXXXXX-XXXXXXXXX-XXXXXX--X-XXXXXXXXX-XXXXXXXX--XXXXXX-XX-XXX
