-----------E-B------------o------B----------------------------------M------?-X-------X-----------X-----------------------XB------------B--------o-----B------------X-----------------B-------X----------
-----------M--?---------------------XX---------------------B------------M-X----M-------------------------?--------------X-----B---------X--------o----------o---B------------------------M----X---------
--B-------X---X-----X------M--------X-------------o--X-?------?--------------o-----------------------------------o----------------X--X--M----------------M-----------X----------------------------------
----------X------X--------oM--?----?------B---------o--------------------o--------------B---------M--------------------M---------X-----------B------------?------X------------M-X---------------M-X-----
-X----------------------------------------MX-------------B----------------------o---------M------------X-----------------?-------------------------o-------M-------X-------------------M----------------
---------?-------------------------------B-----------B---------------------B-----o-------M----------------------Xo------------B-------------M--------------B-------------B----?------M------------------
------------------X---------------------B---------------------X-----------------------------------X-------------------------XXB---X---?-------------------M-?----------X----B------------B-------?------
---------?----------X----X-----------------------B----------------------------------X----------------------?----------------M------------X---?------------------o--------------B-----------------------v
------------------X-------M---------------------------M----------M---B---B------------B---------------B-------------------------------X------o-----X----------X--------o-------------------------------f
-----X---------------o---------------X--------------M------------------------B-----------------------------------------B-Mo-------------M---?-----------X--------------------XX-----------o-o--B-------f
-------------------------T----------------------------------BXB---------T------MB---------X---B------X---M---------------------B----------?-EBM-?----X------X--------B-----------B---------------------f
-----o-o-----------------|--------------------------?-----------------M-|-M--------------M--------B--B-------X-?-X--------------------------B--o----M-----Xo----------------------X-XB-----------------f
---------o-----X-X-------|-------------?--------o----------X------------|--------------------------o----------B-----X------T-----------M--T--M------?-------------T---------------------------------X--f
----o--------------------|--BM--------B-----------X--------?------------|------B-------------------------------------oX----|--M----o------|------o----------------|---------------------------B-----o--f
m-------X----------------|------------------X-------------------X-------|--------X---------------------X-------------------|--------------|-----------------------|------------------------------------X
X-XX-XXXXXXXXXXXXXXX---XXXXXXXX--XXXXX--XXXX-XXXXX-XXXX-XXXXXXX-XXXXXXXXXXXXXXXXX--XXXX-XX-XXXXXXX----X-XXXXXX-XXXXXXX-XXXXXXXX--XXXXXXXXXXXXXXX-XXXX-XXXX-XXXXXX-X-XXX---XXXX-X-X-XXXX-XXXXX-XXXXXXX-XX
