--B----------------------M--M-----------B-----------M--------?---B------XM-------E---X-------MB----XB----------X----B----M?-----BB-----o----oo--------------?-----------------X----MXo-?-B-------X-X----
-----BB-----X---------------X--M---B--B-------X---X----M-o-----X---------?-M-----B-----X-M---X------XXM-----------MB-------------X-M-o---B------------X------X----X-------X---MX----?-------------------
----------o----B-B----------o-X------------o----M----------------X-------X---------M-----B---B-X----------------M--X-----M---X---------------M---------X---X------o-M---?-?--------------------M--------
---B---------------------X-----?-------X--X-----X---B-----B----M--------M-X----B----------------------M------X--------XM-----X--X---X---MX------------M--X-------------M---X-----B---M-----XMB----B-----
----------o----------------B---------------B--oB---------------B-----------------M------------X---------------X----------------------M-----------Bo---------BX------o----------M--MX-------------B------
-----M-?----------M-o---?-------X----o---------------oB-------MM-----X-------MX-------X-X--X-X-XM--M----------------------M----B-B-X---------------------------B-----M-XM--------------------------M----
-------X-X----MM--X------o----X----X--M----------X---X---o-BM--B---------B---------------------B-----M-B-------o------------M----------------o---M--------X--M----------X-EX--o-------------------------
------------------------------------------X---X------?-B---o----------o------------------M-B----XX--?-----X-------Mo---MX----X---B--o------XX----------BM-E-----B----X----B-----X---------B-?-M-------Xv
-o---?----------B---------M--------------o--o-----------------------MB--M----M--B------M---B----------B--X----------------M-B----------------B?-X---------X-------------?-------X---------------M---X--f
---------?-B--?--------------X-----B-M?X-----X-B-----------X-----XX-------------------------B-M---------M--------------------------o---X-X--o----o-------B-----M------Xo------------X--------?-B--o--X-f
--------X-----X------B------------X-?--X------------M-X-BM-----o----------X----------------------------?--BXo------XX----E------------------B------------------o--------------------B----o-X-------X---f
------?X---------------------X-X----oM-X-------MX---------X--X-?-?--o--------M-Bo-MB----------o?------M---------?--------M-----------------------------B---------B----------MX-----------BB------------f
------X---------M---X--?----------------?--------------X-------------?--------------------------M------------------M-------X--------M-B-M----B-----X---X----M-X------------M--------T-------------X----f
------?------------X-------------------------o--------------------B------?-----------------X-?--B--------------X-----oX--B----------X---X------------BM-------------X--X------------X-------o--------M-f
m----------o--------------X-----o--------X-------------------o---------------------------------X--------------------------X--o------------------X-----------------------------------|-----X----------X-X
XXXX-XXXXXXXXXX--XXX-XXXXXXX-XX---XXX-XXXXXXXXX-XXXXX-XXXX-XXXXXXXXX-XXX-XXXXXXXXXXXXXXXXX--XXXXX-XXX-XXXXX-XXX-X---XXXXXX-X-XX--X--XX-XX-XXXXX-XXXXX---X-XXXX-X-XXXXXXX-X-XXX-XXXXXXX-XXXXXX--XXXX-XXXX
