--B------------------------------X---B--XXo-------X-M-----------------?--B-------------X----------BMX-X-----------------X--------B-------------------------------B-----X----o------------M--------------
-X-------------B------------M-X--X----?---------X------X---------X-o-----X-M---M--X----M--X---------------X-B---E---M---B--X----?---------?----B---M-X----M---X-----X--o------B----B--o-?--B------E-----
--X--------o------------------------------?M------M--------------M-?---BX--o-----X-----X---------------X--M-----XM--------------MM-?B--------------o--X-B---MM-X----E---o-----------X----B--------B---B-
-------------XX-X--Xo----o----------B----------------------------------------------------------M------X-Xo-----Xo-M---------X--------------------------?---M-BX--------------------------M-B------------
---B-------X------------------M--o-----------?-E----X--?--------?-----o------------X-E--XXX-------B-o-M-M-------------B-------X------o---X--B-----M--?X-------X-------Mo---o--M----------------X------B-
-B--?---o---BB--B------------B---B------X---M-M------X--X?-B--?---XBX----------X--M--M--B----------B---------o-----?-B------o-----B------------X-----o----B---B-o-------X-B------BB-B---------B--o---o--
----------B----M-----------X-----------B--X------------M-----B-X--X-----X-X-----------X-----?---------?M--E---------------X-----?----------------o-?---------------M-----B------B--X------?-XXEX-B--X---
---------------------------X---------B-------o---------B------------BM--X---------X----X----------------?XX----------------------?------B-------X---------o------B?-----X------?--------------MM--E----v
-B--------B---------------M-o--X------------X-------o-----X-------X------X-------B---------------X------X----------M----------------------XX----------o-----------X-------------o--------------B--B----f
------X----------X-XB-o-?--X?-o?-X----X------------------B--B--------------------?----------X-----oM--X----?-B-?-----------------------X---oM---------------------B-------------?---------B-----------Bf
--------T-B--B--B------o--oo-------------X--X---B-----M------------B-X-----M?--X-T-M------o--?------M?-XM---------X-MX---B--MX--T--------------------?---X----------X--M-X-X---------T-B-BM--X---X---X-f
-----------M-------------------X----------T---------------X----------------------MB-X---X--X----M---?--------------------X--o?-----B--?--------M-X-------------o------B?-------X--M-X-?--XB-M----------f
--------|-----------X-------------oB-XX-B----MT------------------------------BM--|--------------X--o------------X-------------XB|o------------------X-BE----------B----M-T--X----M---|?--E-------------f
--------|M-M-----------------------------B|-----------------E------?----B-----M-M|---------------M----------------M------B----------MM------------X--X-BM-----BX-----M-B-E-----o---M-|---M-----M-------f
m-------|--------X------------------------|---|-------------X-----------X--------|--------X----X-X------------------------------|----------------------------------------|-----------|-----------------X
X-XXXX-XX-X-XXX-XXX-XXX-XX--XXXXXX-XX-XXX-XX-XX-XXXX-XXX-XX-XXX-XXXXXX-X-XXXXXXX-XXX----XX-XXXXXXXXXXXX-XXXXXXXXXXXXXXXXXX-XXXXX--XXX--XXX-XXX-XXXXXXXXX--XXXXXXXXXXXXXXXX-XX-X--XXX-XXXXXX-XX--XX-X--XX
