---------------------------------------o------M-X--------------X-------------B-----------X------BM-B------M---------o---B----?-------------?---o-----X---------B-?X------------B---------XB----B--X-B---
--------------?-----------------X-X--------------o---?-----------------XX---------MBX-------------M------X-------------X---------o----------------o------X--E--------B-B-----------------o----------B---
----oB-o-X------------------X-----------------B---------M--------XX--MX---M---BX----------------?---B----o----------------------X-------------------X-------?------------o-B-----------?-----MX---------
--X-----XM----o-------------------M--------?--X-o------?--------M--Eo-X-X------o---------E--------M---------o---------X--------B-o-B--------X--------------------------o-------------X-----?------------
-----M----X---------XB-----B--M---X-o--BM--------------------------B---?---X---X---------X----------?--------------M-----B----------?-------------oB?------M?-------o-----X-X--B----X----?-?BM?---------
--M--M--X-----M---------------------?--------------------MX----X-------B-------------------------M----X--X--M--------------------M---X-----------X------M-X?BB--M-------X----B---------M----------B-----
----X---------------X-XXo------------------B------------BoB-----XM-----B-M--------B-----XM----------------B---o---------------X--B-----M-----------------M--------o-------X--o--M-XM-M----B----B-o------
-XM------------X------------------X----------------------------B------X-----M----------o----B--------------------oM----B---EB------------B--------------------B-B----------M--o--------M--------o------v
------------------------X----M-----M-----?-------------------B------------X-BXX-----------E-X----M----------X--------------M----X--------X----------------o----------------------?----MM------?o-o-----f
--------M----------X--X----------------M----X-X-BB--------?---------------?-----?------X--?---BX--?-o----------X--?---B------------------------------XX?----------o-------------------?------------X---f
-------M------------M-B--------o------------B-------M-----------------M-------------------------------------?---------XXX-X---------M---------------X?-----------------M----X-------o---B-X------------f
--------o-------B---------B-BX---------M------------------------B--------X--?--X---?-------------------B------B--------M---X-----------------------------------X-------B---------o-XB--B---X--M-B------f
------M---X-B-X-------X---------o-o----------X--XM----------X-X-?---------X--M------?M--X-------------------------------------M--X-----?M--M-----------------M---------------B---X--o----X-------------f
-------------------BM---X---X--B-----o------------------------?X---------B-------M-----------X-------X--X----------XBX?-------B------------------X-----o-o-----------?-X--B---?M--------------o-Bo-----f
m------------------------------X---X--X---o----------------o------------X--------X---------o-----o---------------X----------------------X------------------------------------------------X------X------X
XXXXXXXXX-XXXXXXX-XXX-XXXX-XX--XXXXXX-XXXX-XXXXX-XXXXXXXX-XXXXXXXXXXXX--XXXXXXXX-XXXXX-XXXXX-X-XX--XXXX-XXXXX-XXXXX-X-XXXXX-XXX-XXX--XXXXXX-XXXXXX-XX-XXXXXXXX-XXXXXXXXXXX-XXXX-XXXXX-XXX-XX--XXXXXXXXXX
