-----------------------------------------X------------------B-----------X--B------o--X-----------------------------o--------o------------XB------?---------------B------M-------X----M------------------
--------------------------B-X--------------o-?----M-----------------------------------M---------o?-XX----------------------------------------------------------o----B------------------------M----------
--------B--------------M-------M------X------------------B------?------------------------------------------B---------------o----------------------------------X------------------M----?--------------B--
-------------------------B----M-------E---------------------B--------XB---------------------------------------BM--X---------B--B---------------------------X--XXo--------------------o------------------
--M--------B--------------------------X------o----------------------------------------------------B--------------X--B-------------o-M--------------B-X--------------------------------XE----------------
----------------?---M---------------X---B--B----------------------B-?-X--o-----------------M--------o-----M--------------------------------o----------------------------?-----------?--?---------X------
----B--------------------------------X-----------------------------------X-------X------------------X-----M----------------------X------X----------------------X-----X---X----M-----M-X-M---------------
--------------------X-------------M------------------------------M----------------X------------?-------?-------------B------------B---------X------?-----------------------M---X--o------------M----XE-v
------------X-----------------------------------------------------------------B-----o--Bo----------MX---------------------------------------------?-----o----X--------------------o---------------o--M-f
-----?---o----------X-----B------------------M-B-o------------M-------------------------------------------------------------------------M----------X----X----------------------B-----------?--------M--f
----------?---X--M--------------B------------------------M--X-------------------?---------B-B--------X------?-----BM------------B---M------------B-----------------------------------------------------f
---------------o-------M------?---------------------?---------------------X----------------X-B------------------------X-------------------------------------------------------------------------X------f
----o-------------------------------T---M---------------o--?-----B-------------------B------------X------------------?---------------------------------------------------------X-----------------------f
----o---------------------------M---|--------X---------------------o--------------X-------?----------------X-----X---B----M-------------------X-----------------------X--------------M-X---------------f
m-----------------------------------|-----------------------------------------------------------------------------------X-----X---------------------------------X--------------------------------------X
XXXX--XXXXX-XXXXXXXXXX-XX-XXX-X-XX-XXXXX-XX-X-X-XXX--X-XX-XXXXXXXX-XXXXXXXXXXXXXXXXXXX-XXXX-XXXXXXXXXXXXXX-XX-XXXXXX-XX-XX-XXXXXX-X-XXXX-X-XXX-X-XXXXXXXXXXXXXXXX-XXXXX--XXXX-XXX-XXXXXXXXXXX--X-XXXXX-X
