--B---------------------------------------------X------------X---------------------------------------------X------------X----Xo--------B------------------X------------------XM-XX------------M---------
--X-----------o--------------?--B-------o-M---------------BX---------o-----------M--?------X----------X-?----------?-o------X--------B----?--------------M-Xo------------------X---------M--MMX-------B-
---------------?----------X---------------B-------------X---------------------------------------------------------X-------------------M------o-M--------------X----------------------------?----X-------
------o--------------------------M--------------------?-----X--B---M-------------------------X--------B--------M----B-X--?----------X-M---M-----------------------------------o--------B--------------B-
---X-----------------X----X---------XX-X-o--------M-----------B--------------------------------------Mo--------------M-----------------B-------X--M------------------------B-?----------------------M---
----------------------?---o----------BB--M------X--M---------X------------X---X--X-------------------------X--B-------------------B-o------------------X------X-X--------X----M------------o--X---------
----------------X---B--o----------------------X---------M-----B-----------------------X----------------------------------------M--------------------M---------------------M-----------------------------
----M----------------M--------------X-----X-----M------X---------B-M------------------------?---------?-----------?----------X-M---X----------------M?----------M-------------B----o-B---X-------------v
----B-------B---------------------------------X-------------------------------------------------B-------X------------o-------X----------?--X-----------oX--------M---X--------------------M----X---X---f
------------------------MX------------------X------------M---M-----B------------B--------------------M------M--M---------------------B---X------------X-------------------o---M--X-----------?---------f
-------------------------X--M--------------X------?---------------------B-----------------------------------------------B-----------B-------o--------------------------B--E----------------------------f
---X--------------------------M-------------XB----T---M------------------------------------------------------------------------------------------?--M---------------------?------B-------------------X-f
-----------------------------M--------------------------B----X---------------------o--------T------------B----------------------------X----------------X-M-M---------------------------------------o---f
-----------M---B---------M------------------------|-------X-?------------------------------------B--o-------------------------------X-------------------X----B-------?-----------B---------X-----XB----f
m------------------------------X------------X-----|----------------------------------------o|-----------------o-------------------------------------------------------X----X---------------------------X
XXX-XX--XX-XXX--XXXXXX-XXXXXXXXXX---XXXXXXXXX-XXXXXXXXXX-XXX-XXXXX-XX-XXXX--XXXX--XX-XXXXXXXX-XX-XXXXX-XX-XXXX--X-XXXXXXXXXX-XXXXXX-XXXXXXXXXXX-X-XXXXXX-XXXXXXX-XXXXXXXXX-XXX-XXXXXXXXXX-XXX-XXXXXXXXXX
