--?----X--X-B--------------X-M------------------------------------------------------B-----X--------------------------------------?X--------B-----X--B-X----------M---------------B------------------o---
------------------------------------------------X-------X----------------E------?--------------------------------------X---X------------------------------o----------------BX--------M---------------?--
--------------------------------------------------XX-----------X---------?---------X---X---------------B-----M--------B-------------------M-?--?M---------------?-------X----o---------------X---M------
--B---------------M-----M-------?---------------------------o---XX-----------B-----------X-B-o---M--------M----?--E----X------BBX----------X--------X---------M----------------X-X-----------M----------
---X--------------B--------------------o---------------------------X--------------------------X-------------------X-M------X-----------M--------------------------------o------M------------------------
-B----------------------M--------------------------------?----BM----B-----------------X-------------B-X----------------------------X-------X--------X-------------------------------X--------------M-M--
------------------M---X-M------B----------------------B-------M-----X-B---------X------------------------------X----------------------------------X-----------------------------?-----------------------
-----------o--------------------------------?-----------------X------X-------------M-M--M------------------o-XM---XX----X---M-------------M-------M--------------M----------?------B-------------------v
--M-----------------------------------------------------------B--------------------------------B-M--?Mo-B--X-------B---------------?--------M------M-----------B-X-X----------X----------E---?o--------f
-----o-X---B-------------M---------------------------------------------B----------------MX--------------------M-------M-----B----------------------------------B----X---Mo---------------B-------------f
---------------------------------------------------------------------X-M---T------o------X----------------------------------------------------------------------------------M----X-------------M------Mf
---X----o--o-------------------------------------------?---X----B--------------X-----------------------?-?------------------------?-----------------o--------------------------------------------------f
-TM----------------o----X----------X------------?--------------M-----------|----o-----------------o--------------------------X-------------------------------------B---B--------?---------X------X-----f
---B---??-X----------M------?------X----------------X-----------?----------|-----------M--------?------------B?------X-------B----------B--------------------Xo------M----------------------------?----f
m|----------------X---------------------X----------------------------------|-----------------------------------------------------X---X--------------------------------X--------------------------------X
XXXXXXXX-XXXXX-XXXXXXXXX-XXXXXXXXX-XX-X-X-XXXX-XXXXXXXXXXXXX-XXX-XX-XXXXXXXXXX-XX-XXX--XXXX-XXXXXX-XXXXXX-XXXXXXXXXX--XXXXXX-XXX-XXXX-XXXXXXXXXXXXXXXXXX-XXX-XXXX-X-XX-XXX--XXXXXXX-XXXXX-XXXXXXXXX--X-X
