----------M-------------------M--MX-----X----MX------------------------------------?--X-----------------------------------------XX---X----------M---------------------?----X---X------------------------
-----M-----X--------------X-------------------------M-M-----B-----------------------------------------------------------------------X--B---B-------------X-------------------------?--------------------
------M----------------------X------------------o-X-----------------------------------------M------B-B-------------X-------------X--X------------------o-----------------------------X-X---o------------
--------------------------X--------------------------BX----------------B------------------------M----------M---BX-----------o--X------------------X------------------------M--------M--o-------X--------
---------------------------X--------X------------X--------------------B------------X------M--X--X--------B--o---------------X---------------------------M---BX-----------------------B--X------------XM-
-----M------------------------------------------------X--------------B----------------------------B----------------------X----------------------------?X------?-------------------X---X-?M---X----------
-X------o---------------M-------------B------B------------------------------X---X-----X-M----X---X---------------------X--X----?M------------M----------?-----X-M---M--BX--------M--o-------------------
----X----------X-X-B------------------------------------------------------------M---B----M-------------o------B-X---------B---------------------X------?-----------X-----X-----------------------------v
---------------------------------B--M---M--------------------------o-----------------M-------------------------------?-M-----------BM--------B-X-------?-B-------------X-------------------B-----------f
-----B----XB---------B----------------B----------?-M------------------X--------------------------------M-------------------------X--B----------------------M-------B--------------------------X--------f
----------------------------o-B----------X---M----X--M-------------------------?--------XM-----M------------------M---TB-----------------------------X-----B----------X--------------------------------f
-----------------M-------X------------------X-------------T-------------?---Xo-B-------?-----------------M--------B----------------------------------------------o-----------------------------B-------f
---------------M-------X------------M------B-----X---M-----?--------------------?------------X-B-------?-B?-----------|-----------------XX-----------?-------------?------?--------X---------------B--Bf
-----------M-----------------M----------M--M----------X---|---o----X-----X----B-----------MX---XMB-o--------------M---|----------------------X----------------------X--------------------?-o-------X--Xf
m----X--------------------------------X-------------------|----------------------------X------------------------------|----X---------------------o---o-----------------------------X-------------------X
XXX--XXXXXXXXX--XXXXXXX-XX-XXXXXXXX-XXXXX-X-X-XXXXXX-XXXXXXXXXXXXXXXXX--XXXXXXXXXXXXXXX-X-X-XXXXXXX-X--XXXXXXXXXXX-XXXXXXXXXXX-XXXXXX-XXXX-XXXXXXXX-X-XXXXXXXX-XXX--XXXXXXXXXXXXXXX-XXXXXX-XXXXXXXX--X-X
