--------------X--o--M--------X-----X---------------------M---o--------------M-X---o-M-B------------B-B------------------------?-----X--------------------------------M--------------------B----o-X------
--------------o------------------X-------------------------------M--------------X?---X-M----Xo---------------------------------------------------X--------------o-o------------------------MX-----------
---------B-----------------B--------MX---------------M-------------B----X--------------------------------------B-----B--?----XM---B---------------------X-----X-----B-----X-----------o-----------------
------------------X-------?---------------M--X----------E-------?-------------------B---------X------------------------XM-----------M-----------B-------------------------------------------------------
------------M-------------BM----------------------------X-------X-------B---Mo----------------------------M-----X---------------------o-------------------------------X--------M-X--?-------------------
-------------X--M--X-M---------XXX-----?---?-------------M--------?------B-------------M-------------------------------------X?M------------B-------------------------X----------X---------?--------XM--
---------M--------------?M--------------?M--------------------M-----------X--------------X-----------X------------X-?---?---------M------------B-----------B----------------o-------?---------?----X----
---?--------------------o---------------------o-?M--M-----------------X---M---------------X-M--------------------------X-----------BX---------B------M---M--------------X------------------------------v
-X-------?---------M-MM-------M-------------------------------------B----?---XB-X-X------------------------------------o----X-------------M------M-------------------------------?------X-----B--------f
----------------------------------------------X----M--o--------------------?----o--------M-------------------------------------------------B--o-------B-------------B-----------?----?-----------------f
------B---o----M-B----------------------X------------B------X---------X---XM---------------X------------------o----M-------o--------------------o--------------o----------B------------B----------B----f
---------------M-------------------M-------X--T-------X---------------B-----?-----X------X--M------B--------T--------------------------X-----------------------------------M-------------o-X----------Xf
-------------M-------------------B------------E--B--------M----------------------------------------o---------------X--------------------M-----M---X----X----------M---?------------------------------TXf
--M-------M------X-------------M--------------|------X--M------------------X--------------------------------|--------X-------------------------------------o----M------------------X-----B-B---------o-f
m----------------------X----------------------|----------------------X--------------------------------------|----------------------------------------------------------------------------------X-----|-X
XXXXXXXX-XXX-XXXXXXXXXXXXXX-XX-X-X--X-XXX-XX-XXXX-XXXXXXXXX-XXXX-XX-XXXXX--XXXXXXX-X--X-XXXXXX-XXX-XXXXXXX-XXXXXX-XXXX-XX-X-XXXXXXXXXXXXXXXXX-XXXXX-XXXXXXX--XXX-X-X-XXXX-XXX--XXXXXXXXXXXXXXXXXXXXX-XXX
