-------------?------X------X------o---?---------------------------------------------------------------X------M----------------------B------------------?--X-------------------?---------------X-----X---
-------------B-------------o-----B-----------------?-?-X---------X------?----X------------------------?----------------M------------MX------M-----M--o----------X----M--M---?---------------------X-----
--------?-X--------X-?-------------------------X----------X------------X--X-------------------B--o--------M--X----B---------X-------B-----------------------------------------------XB--------------BX--
-------X----?-?---------B------?---------------------------------------------------------------M-----------B---oo-------------B------M---o-------X--------------------------MX------------------B-------
---o----X----------------M--------X-------o-----B-----------X------------o--------------B-------------X---E---------------------------------------------B------------------X----------------X-----B-----
----X--?-----Bo---------------------MB------M-M------------------M----------------------------o----X-----BM--B--B---------------------X------X------------B--------M----o-----------B-------------B-----
-----------------X------B-----------?-------------------------o---------------M----X-------------------------X-M---------?--X---X------------------------------X--------M-------------------------------
--o-------------------M-----------------------------X------------------------------X----------------X--o--X--------------------B--M------B-----B---------------M--------B--------------B---------------v
-------------------X-------------------o-----B--M-M---X------X---------X---------B-----------X---B-------------------------------------B------------------B-B-------B-------X--------M--X------X--X----f
-------X-X-------------M--------------X-------------------X--------------------------------------------------X------------------------------------X------B---X-------------------------X-----?---------f
--B---X-------------------------------------------B------------------M----E-----------B-----------------M---X-M------X---------------T--X--------------o----M-------------------B---M-X----------------f
-------?-------------------------X---X-----M----------------------M-------X--------B-----------B------------B-------------X---X--o---|-----------o--------?---------------X----------X---------M-------f
--------------------------X---X--------------?-X------X-------------------------o------------------M-----------?---------------------|------------------------o-------o--------X----M-------?----------f
---------------------------------------------------------o-----B---------------MX-M---------X-B---?---------------M---X--------------|--------X--------o--------M--------------------------------M-----f
m---------X------------------------X----------------o------------------------X-----X-------------------------------------------------|-----o--------------------X--------------------------------------X
X-X-XXXXXX-XXXX--XXXXXX--X-XX-XXXXXXXXX-XXXXXXX-XX-XXXXX-X--XX-X-XX-XXXXXX-X-XXXX-X-XXXX-XXXXXXX-XX--XXXXXXX-X----XXX-X-XX-XX-XX--XXXX---XXX-X-XXXXXXXXXXXX-XXXXX---XXXX-XXX-XXXXXXX--XXXX--XX-XX-XXXXXX
