----X--------------------------o------B----------------X---------X---------------------X-------------M--------M-B----M---------------------------B------------------------------------------------------
--------------------------------------------------------------------X------------------------B---X---------o-------------X----------------M---o----o-----------------------------------M-----X----?-----
----------------------------X---X------------------------------X-----------X----X------------------------------------M-------X------o--------X-----B---------------M-----X---------------------------X--
-----X-B--------X----------X----------------------------------------------------------------------X-----X--M--------------------------------X-------------X----------------------B--M--------------oX---
----------------B-------XB----X----B------X------X-----X-------X------B?--B----X------------------------------------------------B--------X-----?------X-----B-----B-------------------------B-------B---
-------------------------M----------------------------------BM--M--------X-M-----------------------------?--X----X-----M--B-X------o----X---------------------------B----M---B-----o----X------B--------
----X-------------------?--X-----------------------------o-----X--X----X------------------B-o----X----?------o------------M--------M------E------X-------------------------------------------X----------
--------X--o--------X----------B---------------X-M-----------o---?--------------------X-------BM----M----M----?-----X----XXB-----------B--M---------------B-------M------------------------------------v
-------?-MBB------X-------------X-----------?----?--------o-----B-------------M-------------------M------M-----o-------X--------------M-------?---------------------X---------------------------B-----Mf
-M--------o---X---------M----------------------------B----------------------------------------------M--B-------------------?-----------------X------------------------------o--M----X-----------o------f
--XB------X-----M-----M---------------------o----------------------X--M-----------X----B---------------------------------------------------------------B--X----------------------------------------X---f
-------------------------B------X----------------B--------------------------X------?-?-------B---X----------------------------X-------------------X-------o----------------X---------------M--?--------f
---------------------------------M--B------------------X---------------------------------o?---------X-------------------------Xo-?XB------MX--------------------B---M----------------B-----------------f
---------------B---------------------------------X---------------------X-------X----X----M-------------X-------------------M------M---------o----o-----M-----M--M---M------X------------------o-?-B----f
m----------------------------------------------o-------------------------------------------------------------------X---X-------------------------------------X-----------------------------------------X
XXXXXX--XXXXXXXX--XXX--XXXXXX-XXXXXXXXX-XX--XXX--XXXXXXXX-XXXXXXXXXXXXX-X-XXXXX-XXXXXXXXXXXXXXXXXXXXXXXX-X-XX-X-XXXXXXXXXXXX--X---X-X-XX-XXXXXX-X-XXX-XXXXXXXXX-XXXXXXXX-XXXXXXX-X-X-XX-XXXXX--XX-----XX
