---------------X------XB-------B-------?----X-M--B-M-----Xo---------X--------------------------X?-?------------------o?---B-------?--M----o------------------------M-------B------X----XXB-X------------
---X-B----X----o---B-----X-----M--------------??--B--------M-----X---X-----------------X--?M---X-----B-----------------------M-M?--------X-------------------------------------------M---o----M----B?---
-------M----M----------?---X-------------M-----X----------M----------B-----B---X-XMB-----------X------------M-XX----M--?------B------------------------------------o----B----------------X-----------?--
----M--------E--------X---------M-?X---BX-M----X----------------X----?M--o------------B-M----X-----X--------------------X---------------------------------E---------------------------------oB------X---
-------------B----------------X---------------------XX--------M------------------X-----o-----------------------?----------M--------------B-------X--M-----X----------o------M---------X-X---------------
------?----------B-X--M---------o--------------------------------X--M-----?---X-X----B----X-------X-------M-B-MB?--------------------------------M---------X----------------M--?-------------?----------
-M------B--?--X------B-------------M--------?---B-----X-----X--------------B---X--------------------X-----------B--X--X---B-------X-X----------------------oX---------o--------X-----X-------------o--X-
----------------X----B---B----X-------M------------X-B-----XE----X-------------------B-M-B---------B-E---X---------------------oM-?--M-----?-------------------?-------------?---------M---B-----------v
---MX-----------------X-----X------B-----BB--?-XX-B---------X-----B-B--?--o--X--M--------------------X------------------XB----------X---------?----------M---?-----------X---MB----?M---X---X------E---f
---?------------BX-X--------?----------------------B---XM--X----X----X----X------o---o----o-------o-M-------------X-----X--M----XE--?------------B---BB--B----X------------X-M-------------X--o----X---f
---X-ME-?------------M--------B------------------------X------XX------------------------------o-------?--X--------B-oX-----------?----B---BB-------M--------------------M------M---------------------X-f
---X--X------------------?------X-----XX---B------B----X----B--X-----X------X------B-X------------------------B-B----o------B------X--------B----o---------------B?--------B-B-M------X---------X---o--f
----X---X---M----------o--o-------------o------------------X------------X-T?-------------------------M------X---?-X----------BX----BX---------X-B-----?---X-------B-X----X---M---------MB-B------X--X?-f
---B-X---------------E----M--XM-X----------------------B------X-o-B--------X-----------------B-o---X-----------X----B-----------------X----------BX---------------------X-?X------------X------M--B----f
m--------------------X-----------------X---X---------X---X---X-----X--o---|---X--------------------------------------------------o------X-o-------o----------------------oX----------------------------X
XXX-XXXXXXX-XXXXXXXXXX-XX-XXXX-XXXX--X-XXXX-XXXXXXX-X-XXXX-XXXX---XXXXXXXXXXXXXX--XXXXX-XXXXXXXXXXXXXXXXXX-XXXXXXXX--X--XXXXXXXXX-XX-X-XXXX--XXXX-XXXXXXXX-XXXXXXXX-XXXXXX-XX-XXXX-XXXXXXXXXXXXXXX-XX-XX
