----------------?-------XB---B------------Bo-----M--------X------------?------------X------B------o---------------------BM----X--E-o--------M-X----------------------M-------o--------M---X---------X-?-
--B--------------------B-XMoX-----------------------?-------------MB--------------------?o-----X---M-----X------M---------X--B---B------------------------X-X---------------B-X----------------------B--
-----EB------B-o-B--------------------X------X-------------?--?---------------X--------X------------------------o---o--------X-----------B----------X---X-------------------X--o------B----X------------
---X?M?--X-X------X-o----------X----B-------B-----------BB-----BB--B---M--X-----XB-----X--X--B---------X----M-------------------------B---B-----M-M--------B------MX-----------------------------B----?-
--X-----------o---------X-----?---B--------?-------------------------------X---o-------------B--B-----B--X------X----X--------X-------------B---?-X------------B------X----X---------M---o--M----XBX----
-----------o----------------X-----------B--------o-----------M---------o----------X-------X-------XB--?------XX------X---B-----X---------X----------BX------?--------------X-------X----B----X---?------
-----X----?--o--o----MB---------B--?----?--?----M---B----B---B-X-------------M------B-----?-----------B?------------------X-----M-----B?-M----M----------X-B---X-?----M----M--------X---------------X---
-X----?----o----------------------------X----------?----M-------B--------X----------?MX--------------------------X--?--------B-----------X----------------M-------M-----XM-XB--X----?------------oM---Xv
----B-------------------X--------B---------M------------B---?------------X----M-oB-----X-------------------?-o-----B--X-XM---B--------------X------------X----------B?-------XX---X-----------------?--f
-----X----o---------------------B---------------------X----XX---------------?X--M-----------M--------X--Xo----------MB-----------------------------------------?--X---X---X--E---M---------X---BX------f
--?------B---?------B--------?--------X---------------E--------------B-EX-------------B-o--------X---X----X---------------o--------X--------M---------?---M-B----X-X---------X--X---M---------M-T?-----f
--M-----?--------?---X-------M------o-------X?------X-B----------T-----B------?-B------B-------?----B---------------MM-----------X-------oX-X-B----B--X---X------------------MBMX---------T---------X-Bf
-------T------o-------o-----M---------X-X------X-X---X---------------o-----o---------------X----B-B---M---------------------------------------------B--X------M--M------B---X-M------M----------|-X----f
--------XMM-MB----------M---------B----B----------------?----B?--|---------------X---X------------M---M---?---MMo-----X--X--B--B----BXM---------------------------------------B-M--M--?---|M----|------f
m------|--------------------------------------------X------------|---------------X-------------------------o---o--------------------------------------------X-----X--------------X--------|-X---|------X
XX---XXXXXXXXX-XX-XXXXXX-XX-XXX-XXXX---XXXXXX-XXX-XXXXXXXXX-XXXXXXXX-XX--XXXXXXXXX-XXX-XXXX-XXX-XXXXXXXX--XXXXXXXX-XXXX-XXXXXX-XXXX-XXXXXXXXX-XXX-XXX-XXX-XXXXX-XXXXXX-XXX--XXXX-XX-X--XXXXXXXXXXXXX-X-X
