--o--o---------------X-o--------o-o------------------------X--------X-----X-X-------------oo----------XX-----o----X--o--------------o-------------Mo-----o----X-----XX-----------o----X----------o----X-
-------o--------X-X-X---------o-o------------------MX--B-----------X-o---------?-------------M-------XX--------X----X---------o-o---oo-X-X----M-X-----------------o-oo------Xo------------o--B-----o----
-B-----X-----o------o-------X----------X-----o-------X-----B----XM----o-?----------X-X-X-X------o-----X--o-X--M--o------?-Xo---X-o-Xo--X----X------X-X-X----------o-X--------------o-M----X----X-X-oo---
---X----X--X---X-----o--o-?--------------------MB------o-------X--X-------o-o--------Xo-----X---------X---------X-----------M-------X----M---M--X--o--X-----XX-------X-oo-------o---------X----X--X-----
---oX----X----M-?---X-o----X-o-----o--------------E--o--XX-------------------X---X--X---------XB---------Xo--X-X-----o------E---------o------------X-X--XX-----------------o-------?---B-o-----o---o----
-----o-----M--------------X-X---M---X-----X-o--X--?---M--X----X--XE-------o--o---X----------------Xo-X--X--oo-B--X---X---o--X-X-X----o-----X----Xoo-Bo-------Xo----------o-------X---M------X--------B--
-----o-o-----X-B--------?----X---X---------o--------M--XoE-----X--X----E-X-------o--X---M-----BX-----X-XX-Bo---o--------XX-?------X-------X--X--X----X---o-EX-----XMo--------X---------o--X---X--o------
-M--M-B-------------BX--------o-X-o-X---X----------------MXE------o----X-X----------o-X----o-------o---------X-----Xo----------X--------X---X-o--XX---X----X----o-------------XX--X----------------o---v
----------------B-X----XX--Xo-----X---?-o-----X---B-------XX-M-----X-----o---XM----o-X-------------------------?----------o----X-----------XX------BX----------X--XX--------X-------------M-------Xo---f
------X-o--------------------E--------------X-E----------B----------o--X--X---------o-X----?--X-X-o--------o------------X------XX--XX-----------X----------X-oE--X-----o--o-----X-----------X-X-X-X----f
-o-----X-------oXXoE-----XX--X-X-----o------X-X---X--o----oo-X-o-Xo-----?------BX----------------X-X----E----M----Xo-X-o----X--X---------------B----o---------X----XB----X---Xo--Bo-M---------X----XX--f
-o--B----?--oB-X-oXX-------X----M---------------B----X--------X-----------E-----o-----------o-------oX--BXX------B--------X--o--E-----MX--------X-------B--X--o-------------o-------------------------of
-o------------o---X-------X----------o---B--X----------B-X--M--X----o--o--XX---o---o---XX------------X----X-BX---------B--------MX--X------M--oX--o-------X--X----B--?--X--oX-o------oX---?---o-XX---X-f
------X-------o--M--------------o-----B----X----M---o---X------------X--o---X-M-----X-------X--------------------M--o--------X----X-X-oB----o-------------XX-------X---o-------M--BX-oX-----------?X---f
m--------------------o------------------------------------------------------X---X--X------------------X-------------------------------------X------------------o-------------T-----------X--o----------X
X-XX-XXXXXX-XXX-XXXXXXXXXXXX-X--XXXX-X-XX-X-XXXXXXXXX----XXX-XXXX-XXXXX-XXXXXXXXXXXXXXX-XXXXXXX-XXXXXXXXXXXXXXX-XXXXXX-X--XX-X-XXXXXXXXXXX--X-XXXX---XX-XXXXX-XX-X--XXX-XXXX-|--XXXXX--XXXXXXX-XXXX-XXXX
