---X----------Xo---M----------------------------------M--?------------------------?---X-----------------X-------M---------------X--------------------------M---------B-----B?---------o----B--------M-B-
-------------B--M---M-M---------M--------------X-B--------------M--------M---------------M------X----X-o--------------------B---B-----B------------------------------X----------------------B-----------
------M-------B---------------------------------?-------------M---------------------------------B--X----------------------------------------------------------------------------------------------------
------------------------------o-------------?-------------------X-----X-------------------------o---------------X-oo-----X----X----?---X---M---------X----o--------B-M----------M--M-----------o--------
------------B---------B?------------X----------------------M-----------------o----E----X--B--B--------X-------------------------------X---------------------M-------------B----B-B----------------------
---------------?B-------------o------X-----------------?--------?-----B---M-------X?-------------------------X-o---B---------X-------------M-------------------------o-----------------------------B-o--
---------------------------M-----X----------------------X---------------------------------------X---------------?-B-o-M----------------------------------M-X---------?B----------B----------------------
--------------------M----------o---------------------B----X----------------------------X-------------o---------------------B----M------?-----------------------X---B----M-----X------B-----------X-----v
--------------?---M--B-----------------------B--------B-------------------X---?o-------------------------------------------------------------XX----------X--------B------------------------------------f
----------------X--X?BB--------X-B------------------M---------------X-----?------------------------------X-------------------------X-------------------M---------M----------------------------M--------f
---------------X----------B-X-------------------M--------------------------------------------?-------------------X----------------o-------------------------X-X-----?---------M--------------B---X-----f
---------M----B-----T------------------M-----------M-?-----------B--B-------------------------------X-?X-M---o-----------------------------o---------X--------X---M---X-o--------o-------X---oX-X-X-X--f
----M---------------|--------------B---------BB----------------M--------------------M--?-X--------M--X?---------X-M----M----------X------X---B-------------------------------------------------XX------f
--------------------|------MM---X---X-------------?--------------------------X---------X--X------------------------X---------B------------M-M--X-----B-----B---------B-----------X-------B-----B-------f
m------X------------|-----------------------------------o---X--------------------------------------------------------------------o------------------------------------------------X---------X--o-------X
XX-XXXX--XXXXXXX-XXXXXXXXXXXXX-XXXXXXX-XXXXXXXXXX-XX-XXX-XX-X-XXXXXXXXXX--XXXXXX-XXX-XX-XXX-XX-X-XX-XXX-X-XXXXXXXXXXXXXXX-X-XXX-XXXXXXX-X----X-XXXXX-XXXXXXXXXXXXX-XXXXXXXXXXX-X-XX-XXXXXX-XX-XXXX-X-XXX
