------------------------X-----------------------------o--------o--------M---------B------X--------------B----------o----------------------B-B----?-M-------------------------------------M-----X--?-----
---X---o-----------------------M------------------M--------------------------------------------M-?-X--------------M------------------B------------------------X------------------------B-X---M----------
--------B------------------o----M--M---------------------B-M------------------o--------------------------------------------o-B-------------------------X------X-----------------------?-----------------
--------Mo---------------B------------E----X---X---------X-?B------------M---------------------------------M------XB---X----B---?-----------------------------XXo------?--------------------------------
--M---------------X-------------------X--X?--o------------------------X-----------o--o---B--------B--------------X-----------------------------------X-------------------oo------------------------X----
-------------------B-----------------------X------?-------B-------B-?-M--------------B--------------o----------------------M---------------o---B---------------------------X--------?--?M---------------
----B--------------X--------M---X--------------------------------------o-X----------------------?----X-----------------?---------X------X-B-----------------------------XX----M---------M---------------
--------------------X-------------?------------B---------B-----X-M--------------------------------------------------BB-M------------o-------X------?----------------------?M---X--X------------M-------v
------------X--B------------B-------------------------------------------------B--------B-M----------X----------?-M------X--------------------B---------------------------o--o-----o------------------M-f
-----?--------------------M-------X--B-------M-?-----------------?-----------------------------------X-------------X-----M-------------------------X---------------------------B-----------?--------M--f
----------?-------------o-------B------------------------M--X---------X---------?--------BB-B--------X------------B-----------------M---------------------X-------------------X------------------------f
---------------o--------------o-------------------------------?---?-----B-X---------------XX----------------------------------------------------------------------------------------------------------Bf
----o-----------------------------------M-----?------------?-----B---------------------------?X---X------------------?--------------------------------X--------------B-o-------X-----------------------f
----o--o------------------------MM------------------------------------------------X-----------------------------XX--------------M-------------------------------X-----X----M---------M-X-------------X-f
m-----------------------------------------------------------------------------------------------------------------------------X-------------------------------------------------------------------o----X
XXXXXXXXX-XX-XXX-XXX-XXXXXXXX-XXX-XXXXXXXXX-XXX-XXXX--XX-XXXXXXXXX-XXXX-XXXXXXXXXX-XX-XX-XXXXXXXXXXXXXX-X-X-XXXXXXXXXXXXXXXXXXXXXXX-XXXX-XXXXXXXXXXXXXXXX-X-XXXXXXXXXXXXXXXXXXX-X--XXXX-XXX-XXX-XX-XXXXX
