--X-------------o------------------------o---o------------X--------o-----o----o-X------------Xo-X----Xo--XoXo---o--------o---------oo-----o----------------X-------X--o-----------------o-------X-------
-----E-----------E-------X----o--------o------------X---?B----?B------X------------------o------------Xo-o--XX---------X----------------------------o-------o-------?----?M---o---M------X-?M-----------
-Xo--X--Xo-----MBX----BX----o-----X------XXXX-----o--o-----------B--------XBX-X--------B---------o------------X-o--X--------o-------B-----B--XXo------X-Xo-X----?----------------------------X-o--X--XX-
-------XX-X--------oX-----X-------XE----XX-----X-----XX---o-------------------------B---XB-B---X-X-------X--o-----------X-X-X---------o-----M------------X---XX--X----X---X---X--M-Xo-------------------
------X------X------X----o-?--oM---M---o--------X-Boo-------XXo----?---o---X-o----X----X-----oX-XX-----X--X----oX---X----X--oX--X------------------------ooXB------o---------------------o-?---B-----o--
--o-----M---o-----o-X----o----------X--------X------X--X------X------X---E-X--------E---o--------X------o-X--------------------o--------X-----XB-----o?---------o------o----o----o-XoX-X-o--o-----------
---Xo-----------------X------E-o-----------o--M--X-oX-XX-o--------X--XX--X-o------M-X-X-----X-----------------o----M--B-XB----B-----XX------XX--o---X-------X--o-MM---------X-X-X--X--------o-----------
----o-------o-----o--------X-?-------X---------M----------------??----------XX-Xo---o------------------Xo-----X--------o--------o--------------o----------M---oX------o----X--o---------Xo--------o-XX-v
-B---?--o-------------M---------------Xo--Xo---------B---X--X-X-----o------M----oX-------X--X--M-XX---XX---o-X------Xo----M---X-------X---o--------XX--------o-X---o------M--X----X-----XX---M---o-----f
---------------o-o-------X-X---------------X---X---?-Eo-X---o---------------o---------------o-------X-----o-------o---o-----o--o----XX-X-----X-----X--X---o-B---o------X-------o------XE--o----X---o-XMf
-B----oo---B---XX----------o---------XX---oo--X------X-M--X--X-X-----XX----------BX--------X-B-X---------M----XBX--o---o---------X-X-----oo-X--X-------X-----XMX-X--X-E---X---B--?o----B------o---o-X--f
--o-M---M------o-----o--M---------oXXo-o------o--B-B-X-----X-----X----------o--------o----o-------ooM--B----Bo------X------------------o-------X------X--?-X----------B-X-----------------o----?-M--o--f
-------------XB--o--X-----?------------o-XM---X--E-------o--------B----X-----M-----?X--XX-------M----------------X---------X---------X--------o--E-------------o-o-X---o-Mo---X-XB---X------------B---Xf
--------M--oX--X----X-oo----------M-----X-----X--?-----o----XX-Xo-------o------------X----o---------X--o--?--------------------X------o--------X-Xo----------M--------B------X--------B--X--B-X-B------f
m-------------X---o----------X--------------o--X----------------------X---------o------X----------------------------o------------o------------------------------------------------------------------o--X
XXXX-XXXXXX-XXXXXXXXXXX-XXX-XXX--XX-X--X-XXXXXXX-XX-XXXX-XX-XXX---XXX-XXXXX-X--XXXXX-XXXXXXXXXXXXXXX-X-XXXX-XXX-XXXXX-XX--XXXXXXXXXXXXX-----X-X-XXXXX---XX-X--XXXX-XXXXXXXX-XX-XXXXXX----XX-XX-XXX-XX--X
