-----M-----------------------B-------------------M---------------------------------------------------B-----B---------------------X--------X-----B-------------X--------X---------?----------------------
----o---------------------B--------------------B-----------B---------------X-------o---------B----?-----B------------------B-M---------------B----------o---X-------------------------------------------
---------------------------------------X------------------X-----M--------X---------------------------M-M-----------B--------------o----------------------------o-X----------B-----oMM---M---------B-----
---------X?-------------X-------------X--B----M----XB-X------X--------------------------------------------------------X--------------------------------------------------------X-----------B----------X-
--?-B------------------?------------o----------o------------X-----------------------------------X----X-----o---BX-B-------B------------------------------------------XB-----?--X------------B-----------
---B---------------------M---------X--------------------X--M---------BBB?oB----------------------------------?----o--M-----------------XM--X---M-------------------------------------B------B-----------
----M----------------X---------?--------X-----X------------o---X---------------------------------X--X------B---B----------X---------------X-------------------------------?------------B---X------------
----M-?----------?---------------------B---o--------------------B----B---------M------------------M----B--------X-X--------------------B------------------X--------------------------------M--M-X------v
------------X----M------------------------------------------------------------M---------o------------E---Bo---------------------X-------------X----X----------------B---X---------------X-------X------f
----B-------------B--B------------------------------B-X-----------------X-B------------------M------XX--------B-----------X-X?---------M--M--------X----------------M-------MX--------X----B---M----M--f
----T-----------X---?-X-------X--------X-------------------------------------------------M-M--------M---M-----------------------B---------------M--------------B------------------X--------------------f
----------------------X---------------------------------------X------------------------------------------------B--M------------------B---------M-----------------B--B--------------------o------------Xf
--EB|--B---M--E--B-------------------B---BM--------------T------------------------B----------------------------------------------B----------------X-----------M------------X----------------o----------f
--B-|--BB--M-----B---B------------------X-------------X-------X----------?-----M---------------------------------?M------X-o---------M---------------------------------------B-------M---------M------Mf
m---|---X-------X---------------------------o------------|-----------------------X------X---------------------o---------------X----------------------------------------o-----------X-------o-----------X
XX-XXXXXXXXXX--XX-XXX-XX---XXXXXX-XXXXX-XXXXXXXXXXXXXX-X-X-XXXXX-XXX-X-XX-XXXXXXXXXXXXXXXXXXX-XX-XXXX--XXXXXXXXXXXX-XX-XXX-X-XX-XXX-XXXXXXXXXXXX-XXXXXX-X--X-XXXXXX-XX--XX--XXX-X-X-XX--X--XX--XXXXX-XXX
