----------M-----------------B-------?-----?-----------------M---------?-----------X---------------B--?X------BX-------X------?------------X---------------XM---------------E----------------------------
-----------------------------M-------------------------------M?-------------------------------------------------X---M--------?--------------------------------M---------M---------X-----M---------------
----------X-------------B-M------X------------X--------o----------------M--X-------------------X--------?--M---X-------------------B--------------------o----------------X-MM-------------M-------------
-X--------------?-M------X----------?-----------------------M-M----?-------M---------------E----------?-?---------------------------------------------------X--------X--B-------------------------------
--------B----M---------------------------------M--------X-------o-M--?-------------?-------M---------------M-X-------X------B-------------------X---------B------------B-------X-B-----------M----------
-----------------------------------------X-------XB-------------------------------------------------B--X?-----M----------------o---------------------XM----------------------------------?---M----------
-------------o-X---------?-------------B---------------------B----------M--X-----BM---o--??-----X---X------------------------------------------------------------X----?--M----------------?------B------
------?-----B-X-----------X--------------------------oo---------?--------------------------------?------B-------o-?----------X-B----MB------------------M-?-?------?-X--B---------?--------------------v
---?------------------X-------------BB--o------------E--X--M---B-----------------M----------------X---------------------------------o----------?---------------------B------------B--------------------f
------------------------------------------------X-X--X------X---X-o-------X-?---M------------------------------------X--------o-----X--?---------------------------------------------------------------f
--------------X---------B-X---Xo-------------------M--X--------M---------B-----------X------o-X--------------------------------X-?-B------------------------------------------B--oo----o-----------X---f
--X---------X----o-----?----o--X----------X-------------B-B----------------o-------------------------------------------X----------------oB-----------o-------B--B----------------X--BE----------------Xf
-------------------------X-----------M---X-------o--------X----------X-------------M---------------B-------------?------X----------------B----Xo---------------------------------T-M-B-----------M-----f
-----?--------------------B---X-------------o-------------XX---------?----------------------X--M--------o--------------------o---------------------------MX-?-------B-----o------X---------------------f
m----------------X----------------------------------------------X-------------------------------------------------------------------------------X-----------------------X--------|---------X---------X-X
XXXX-XX-XXXXXXXXXXX---X----XXXXXX-XXXXXXXXXX---XX-X-XXXX-XXXXXXXX-XX--XXXXX-XX-X-XXXX--XXXXXXXXXXXXXX--XXXX-XXXXXXXXXX-XX-X-XXXXXXXXXXXXXX-XXXXXXXXXXX-XXXXXXXX---XXXX-XXX--X--XXXXX-XXX--XXXX-XX--XXXXX
