---------X-------X------o--------------------X---o-------X--X---o-X--o-----Xo----o-------------------X---------E---o------X--X---X----o-----o----X--X----oXo------o----------------X--oX----o-o-X-------
-------?-X---Xo-----------o---X----oXo-------X---X-------------------oo-E-X------X----?B?----------------------?---------X----------------o--------X--M--------------X-M------------X-----oX--o---o-----
--------o-oX-X-Xo-M-----oX---X-----------X-----o-------M-oo---B-----X---X--XX----X?X-----oX-------------X----o--o--B------------?------o----B--XBo----------X----X----------Xo-M-----?--X-------B---XE--
----o-------X-------?--B-o-M------o-X-XX-X--M-X---XM----------------Xo---o-----X---oX---o---------------oo-----oX---o--o-o-o-------o----------M--------o-?X-oX----------o-M-----------Xoo------------B--
-------X-----X--X-------BX---------X------X----------X--X------MX---------B--X--X----o-o-----o--M---o-X-----X--X-X---X--X----X--X----B-------------o---o-------------X------------------o--o----o-------
----XM----------X-----X-------------o-XE--------o-o----B---oo------X--o----------?o-----o---------------X---X-------X------------------oX--X-X--XX-ooM--M-------MEoX------------XX-------------------XX-
---X--X----------XX----o--o-------o----XB-?---o--o-B-M--------o-Moo--X----BX-o--------------------X------X-----?-o------X--X-----------------------X--o----------XX-X---?--o-o------MX--X---Xo-X-B--X---
--------X-----------------------?---o------M-X---------MB-----------X---------oo-----------XX----------o---o-----X---M-B----X-M--X-o----------M---X-----------------oo----o--o----X----------o------o--v
----------------X--E----X---Xo------Xo--X----------B----------X------XX--o-o--o---X--o-----X-o-o-?-B-----X----------------X----o------o-----------X------------M-----------B------------X--------X-----f
----o---XX----X----X------Mo-------X-X--X-------oo----o----oM-----X--X--X---o-----------o---M--X-----o---o-o--X---o--XM-------------o----M--X--X----------MM------?-XM--M---------------X-----o-X-X----f
----------X----X----X----------------------X-----oX--?-M-X-------o------------X----oo----------X-------o--Mo--X--Bo-----oX------o------X---X------E-o--------M-----------X-B----B---------X-X---------of
-o----------o---X----M-----o-B-BX-X--------------X-X----M----X-X--M----o----o--o------M---?---X---------------X---X--------B---X---B----E-X-------M--X----o---o-X-------o---X------X-------X---?-------f
----o-XM---XoB-----o--o--------------B--X---X---X---X-----X--------Mo---Xo--o--o--------o--X------M-X--------B-----------o--X---X-------X---XM-----Xo----o---X-X-------oXB--XX------X-------X--------X-f
--Mo-----X-----oX-X---oX--?B-------X-----o---BXX------o---------X------X---------o--X--?---X----?-----o----X------o----------B-X-----B----------------oX----M-------------?---o-XX----X---?-Xoo--B-?--Xf
m-------------------o-ooo---------------X--------------oX------X---------------------------X-----X-------------X--X------X----X-------------------------------X-----------------------------X----------X
XXXXXXXXXX-X--XXXXXXXXXXXXXXXXXXXXXXXXX-XXXXXXXX-XX---XXXXX-XXXXXXXXXX-XXX--X-X-X-XXXXX-XXXXXXXXXX-XXXX-XXXXXXXX--XXXX-XXXXXX-X-X-XX-X-XX-X-XXX--XXXXXX--X-XX-XXXXXX--XX-XXXXXXXXXX-XXXX-XXXXXX-XX-XXXXX
