---B---------X-------B----M--------X------M--?-------------X-M--------B--------XX---------X----B---?------------B-----------------o----------M------o--------------------B--------------XM--------------
----------------X-------------------------------------------------------------------X-----------------X--B-----------------------------------X---BMX------------X------------------------------X--------
-------X-----------------?-----------------X-------------------X----------------------------------o---o---------B--X-----------------B-M-----------------------------------------------------------BB---
------------------------------------------M-------B------?--------------------?----------------------X------------X-X---------------------?--M---------------------------X---------------M-------M------
---------------------------X------------------------------------------------------------------------------------B-o------M----------------o-----M-----------------------------X--------------B?---------
-----------X--E-B------?----M----------M-X-----------------------X--X-------?-X------------M------------M--------------------------------------------B---------M------------B------?-----------B--------
-------M----M-M-------------------------?---------------------------------X?---E----B--------B-----------------------B-------B----------------?---oX----------X------X----------------X-------X---------
----B-----?-----X-----------------X--------------B--------------?--o---X------XX----------X----------------B----------------------------------------o-----------------M--X---X-----B-------X----M------v
-------------B----X-------------------------B---------------------------------?--B----------?-----------------------------------M-----o---------o------o----M-----?--------------------------X---------f
---------B-----------------------MB--------------------------M-------M--X-------------B-------M-oX-----M-M-------------MX---------B--M---?o-B--X---B-----------M---B-B--B-B----------------------------f
--------M-M-----T-------M-------------X-----o--B---B---------B--?---X----------------M--------------o---------o------------------------------X--------------X------------------------------------------f
-----X----------B--------M-oo-----------B----M------------------M-------------------------------------------------X----------M-------------B----?o--------------------------B-----M---------------M-M--f
----------------|-----M----------------X--X---------------?M---------------------------------------------------------------------------X-M----M-------oB---?-X---------B-------------X-----B-------B---f
---------M----X-|---X--------M-----------------?o----------------------------------------------B---XX---------------M------M-o--B----X---B-----------X--------o------------------------X--?---------X--f
m---------------|------------------------------------------------------------------------X------o------X------X----------------------------o-----------------------------------------------------------X
XXXXXXXXX-XXXX-XXXXXXX-XXXX-XX-XX--XXX-XXXXX-XXX-XXXXXXXXXX-XXX-XX--X--XXXXXXXXXXXXXXXXX-XXXXXXXXXXX-XXXXXXXXXXX-XXXX-XXXX-XXXX-X-XXXX-XXXX-XXXXXX--XX---XXX---XX--XXX-X--XXXXXXXXX-XXX-XXXX-XXX--X--XXX
