--X?-----------B--o---------XX--------------X---------------------------B------------------------o----------B-----------B-------------X---------------?-------------------------------------------------
----o---------------?-------X-------------------------B-------X----------?-----M-----------------------------------------X--------------X--------?------------------X---o---------B?--------------------
---------X--------X-----M-------------------?----M------------X--BX----------M------X--------------------------o--?MB---------------------------------M------------M----X-M?----------M-------X---------
----------------X------------------X--X-------------------?------X-----------------------M-----XM---------------?------------------------------X--------------------------B-----------------------------
----?-------B-----XX------------------X----------X--M-M-----X-----X------------XXo-------B---------?-----------------------------B------------B---------------o--------------o--------------------------
-------------------X---------------M---M----X---------?-E---X------B--X----B---X-------------------------------------B-------X--X--X--------o--M-----------X--------B--?-----------------M------------X-
---------------------X----------------------------------B--------------------------------B---------------------o---------M-----------X--?------o--------------------------------------------------------
-------B-----B---B--------------X---------------------------------B----------------------------X-----------------------X-----------------MMM--------------------------X--------------------------------v
-MB------M-----B-----B-----------------M--M-----B?o-----------------B-------------------M-?----------------------X-M----------------------B----------------------------------X-M---------X------BX-----f
-?--?-----Bo-----X--------------------------------------?----BX-----X------------------M------M-------BB--------------------------??-------?M-----X---M---------XXX----B-------------BX-?-----X?---o---f
-----------------------------------?MM---------TB-----------------------?------------------------X---------------------M----------o-X------?----------------------?----?-----------M--M---MM-X---------f
--------------T------B---------T------------------B------------------o-----------M-------------------M----------------------------o----X-X----o---M-----------------------------M--o----X--------------f
--------------M---------T---M--E------?--------|-------------B------------------------X-----------M---------------M-----------------X---------------------------------B--T-----------------------------f
----X---------|----------------|--B---X------?-|--M--------------------------BB--B-------------------------------------------------M----------B-------------------M---------B-----------X--------------f
m-------------|---------|------|---------------|-------------------------o------X-----------------------------------------------------------X---o----X--X----------------|-X---------------------------X
XXXXXXXX-XXXXX-XXXX-XXX-X-XXXXXXXXXXXXXXXXXXXXXXX--XX-XXXXXXXXX-XXXX-XXXXXXXXXXXXXXXXX-XXXXXXX-XXXXXXXXXXX-XXXXXXXXXXX---XXX-XXXXX--XXXX--X-XXXXXX----XXX-XXXXXXXXX-XX-XXX-XXX-XXXXXX-XX-X-XXXXXX-XXXXXX
