------------o-----------X-B------------MX-------?---------------X--X--------------------M----XX----------------B------------------------------------------X-?-------------------------------M-X----X----
--------------o---B----X----------------X------X-----------B-------------------------------------X-------------XX-M---X---X------------------------XM---M------------------------------------?M---------
-------------------------------------------------------------X--------X------------------B-?---M-----X------X---------------------------------X----------B--------------------B-------------B-----------
-------B----------------------M--------o---o-----B--------------M------X---X-----------B------X------B-----------------X--------------------M--------------------------------------X-------M------------
----------------------------X-----X------------------------------------------------M----------------------B------M-------------------------X-----------------------X-B--------------------o-------------
-----------B---?B------------X---------------X----?----MX-------------------X----------?--B------------------------?------------------X?------------?-X---------------B------B--------------------------
--o----------------M----------------------------------------------------------X--M-M----------------?--------M---------------XX----?---------X-----------X----X-----------------------------------------
----M----X-------X----------------------B----------------------X-----------------M--?----------------X---------------o-X---X-B--------X----------------------------------------------------------------v
-------oX?-------------o-----------X------B----------X-M------------MM----------------------------------M--------------X----------------------------B----------o--?--M-------------------B-------------f
-----------B--------------------M--------XM--------------?---------------oX----------o----------------------------------------------------------------?-------B----------------BX----------B-B--------Mf
---------X-B---------------------B-------XB---------------------------------------------------X----o------------------------X--?-X--------o---------------------------?----------------------X-----X---f
-----------------M---M-------------X--X---M------------------X------------XB--------X---------------------------------------------------XM-----?----------X-------------X----------B-X-------B--X-X--M-f
--------------B-X----o-----X-------------M------------------B------------X--M-----B------------M------o---M----------o---------M--------B--------B----------------------------------------X----------E-f
---?---------------------B--------------o--B------X---M----o--------B---------------o---------------------M------B--------?--M---M----------o----X-----------------------------------X------o--------X-f
m---XX------------------------------------------o------------------------------------X-------------X--------------X-------------------------X-------------o--------------------------------------------X
XX-X-X-XX-XXXXXXXXXXXXXXXXXXXXXXXX-XX-X-XX-XX-XXX-XXX-XXX-XXXXXXXXXXXXXXXX-XXXX---XXX--XX---XXXXXX-XXXXX---XXXXXXXXXXXXXXX-XX-XX--XXXX--XXXXX-XXXXXXXX--XXXXXX-XXXX-XXXXXXXXXX-XXXXXXXXXXXXXXXXXXXXX-X-X
