---M-----------------X---EX---------------------------------------B---------------------?--B---------?--------------------------------------------------------------M------------------X-M-----o--------
-B------B----------M-----B--------------------------X---------------------------------------------?-----------------M--------B-------------------------X--------------------B---o-------X--X------------
-------------------X--X---------B--------------------------------------------------M---------B-o-------o-------X-----------?-o-X-----M----M----------X-M--------------M---------X-----------M-----------
--o-M----?--M------------X------------------------------------X-X---------------------X------X-------------M-----------------?------------------X---X-----o-----------B--------------BM-------M---------
-?---------------X----------------Mo-------X----------------------------------------M-----------------------------X-B-------------------B----BX-B-----M-------------------------M----o---B--------------
---------X---------------M--?-----X--------X----B-----M-----------------------X-?---X--------------------------?----B--------B-------X-?-----X-------?-M-B-----------X---------------X------------------
----------X------------------------------------------B--B------------------------------------------o----------------------------------------------------------X------------------------------M----------
-----------M------B-------------------------X---B-----------X----------------------------------X----------X-M---o---XM-o---------------X-------X-----M-----o------------X------o--------------------M--v
-----------------X--------------X--------X-------o---M---?-----?----M--------X---------------B----X------------------M-------B-------------B------B------------------------------EX-X---------M--------f
---------X-------------------oX-M-----M-----------E------------------------X------------------------------X--------------------------------------X-----X-------------------Bo----X-------------M-------f
-------X------------------------------------------T--------M-X----------------------------------------o------X----X-------X----B----B----------M---------------------B-------------------------MX-B----f
--------B-----------MB---X-------X-----------X----|--X---------B?----X----------B-----------------------------------T-X--------X---------M------------------M-----------X--------X--------X------X-T---f
---------?---B--------------------------B------X--|------------M-?--X----------X--------------o-B-------------------|---------X--X-------B-----------M-------------B-------X----X---------B-XX?----|---f
-B-----B-----B------------------------o-----------|-------------X-------?--------------o------B--------X-X---oX-----|--------------------------------------o----o--------X-----o-------------------|---f
m------------------------------------------X----X-|--------------------X---X------X--------------------------X------|------------------------------------------------------------------------------|---X
X-XX-X--XXXXXX-XXXXXXXX-XXXXXXXXX-XXXXXX-XXXXX-X-XX-X-XXXXXXXXXXX-XXX-XXXXXXXXXXXXXXXXX-XXXXXXXXXXXXXXXXX-XXXXXXXXXXXXXXXXXXXXX--XXXXXX-XXXXX-XXXXXXXXXXXXXXXXXXXXXXX-XXX--XXXXXXX-XXXXXX--X--XXXXXXXXXX
