-----------o-------------M-------------B-----o--------X------------?-------------?--------------------X--------------------------------------M------------------------------?--------M-B----------------
--------------XB--------------o------------M---------------------------------X----M-----------------------------E-----------------B------------------------------B---------------------------------B----
-------------------X--------B---------------XB--------------------------------M------------------XM--------X--B-X---------X--------------------------------------------B---------------o------B---------
----------B--------M-M-----------------------------X-------------------B?---------------------------------M--------------X--------------------------------------X-----------------o-B-------------------
-o---?---?---------------------X---------------------M----E-----------------M------X----X---------M------X-----------X-------E--------------X-----------o-------------------B---M-----------------------
-X----------o-----M-----o-----------------------?---------X---------------------------Xo-------------------------------------X----------------------XM-------------BM--B--------o----M-X-----X----------
--B---M-------------?----B------B-----------------------?M---B------B--------------B----------B--------------?---------------?------------M----------?-----------------------o-----B--------------------
-----X-------------------------------------------?------B-?---?-------------M-------------------X-------------------------?----o-----?----o--X---------?------X----X-----------------------------X-----v
----X---M---------------------B----B-o------o------------------o--------?----B-------------?----------------------------M-------------------------------B-----X-----------------------------------B----f
--------------------------B-------------------M----------------------------------------------------B---B-------X---X--------?-----X-----------B--------------------?-----?----------X-------B---B------f
-----------------B------------------------M----B------B---------------M-----X--M----------------------------X---------X--B---------X---------------------------------B-----------------X---------M-----f
--X--------------------------X--------------------B----------------------?----------------------------?-----T-----M-----M---M------------------B-------------------------------------------------o-----f
--------X----------B--X-----B?---o------------?-o-----------------------------------------------------X----------B---------M--o------o-------------------------------------MX-----------------------B--f
-M-------------o-----------X--------XM------o---------B-----------------?--------------------X--------------|----------?--M-B---B-------------------------------B-X----------------------X-X----------of
m--X-------------------------------------------------X-----------------------------------o------------------|----------------------X--------------------------------------------------X----------------X
XX-XXXXXXXXX-XXXXXXXXXX-XXX-XXXXXXXX--XXXXXXXXXXXXXXX-XX-XXXX-XXXXXXXXXXXXXXXXXXXXXX-X--XXXX-X--XX-XX-XX-X-XXXXX-XXXXXXX--XX-XXXX-XXXXXX-XXXXXXXXXXXXXXXXXXX-XXX-XXXXX-X-X-XXX-XXXXX--XXXXXXXXXXXXXXXXXX
