---B-X---------X-----BX----X--B-X-----o---------------------M-----?---X--M------------M-------X----------B--------X-----XX-----X-----o----------------------?--------MX----o-B------X---------X--X---B--
--E-------M--------B---X---X-------M----XX------------o-------MBo--XM-----------X---X---------XE-M------------------------------------?----X---M------------------?-----------BB-----M--------o---------
--------Eo-------B----------B-------------o-B--------------M----X-----------B---------------?--X-------?------B?-----M--B----Xooo------X--?-------------XM-?---------------M-X-----------------------??-
--------X-----------------B--------M-----------X--BX-------------B----M---------X-M-B------E---------B-------X-------M-----MM---------X----B--o----o-X---------X---B--------X------------X-?----X-----B-
----------B---o-------------o---?----M-----X-----B-----------oX--B-----?B------------------M--------------X---------X-o-----MM-o---------o------------BB--------X-----------------------E---------------
---B-----------B-MB-----------------X-----M-------X----?--B--------------M---o-----X-X---E-------o-----------oM--B-B--------X--------------X----------?--------M----o-----------oX------XX--------------
-X-------BX-------X-----------B-----o--------------?-------------E----X-?---------------M-----------B-----------?-------X--------------B---?---o---------?X--------MX---B--X--?------M------X-X-o-----B-
-----------------?-o-------X------------------B--ooo-----M------XB------X---B-M------------B----X--------M--------B------X----X-----X---------------B------M--X-----M-----B---------------------B------v
--M-B-E------XX-----------?---------X-M-o---B-----------------X-B--MM-----------------------------------------XB------------B----B-----------------X-------M-B-----X--------?-----------XX---X---------f
----X-X---------MX----XM--------------M-----------o-------XB------X-----------B----------M----B--------------X--X-------B-----M----B--------------------X-----------?------------X-----------?-----B-B-f
----------X-B----o-X-----X--------------o-oT---X-----?---------------X----------XM-------X------------M----M---B-----------------------------------------X-?----------XXX-----X----------B-B-X---------f
-?-----?-------o-B-M---XT-?----------B---M--B-----B-----T----?B-----------------B-----------X-------------------BB---------X--B-----------------------B----X------o-------------XE---B-M--?------------f
-----B------M------o-B-X-------?X----------|-X---M-----M-----MXo--X-------XE-----M-----M-B---MB------------X--------X-B------X-------B-------E-B--o-------B-----?------B------B--T----o----------MX----f
---------------------?-?|X------?----------|X-----------|X-----o------?---o--X---B------o---M--XM--M----B-X--B-o----X-------B-----?------?-X-B-----------XBB---B-----X--X-X----X-----X--M--------------f
m-------------------X---|-------X----------|-----X------|--------------X-------------X------X--------X-------X--------X-----------o--------------------------------------X-------|----------Xo-o-X----XX
XXXXXX-XXXXX-XXXXX-XXXXXXXXXXXXXXXX-XXXXXX-X-XXXXXXX-XXXX-XXX--XX--X-XX-X-XXXX-XXXXX----XXX-X-XXXXX-XXXXX-XXXXXXXX-XXXXX-X--XXXXXXXXXXX-XX-XXXXXXXXXXX-X-XXXXXX-X---XXXXXXXXXXXX-XX-XXXXX--XXXXXX---XX-X
