-------------------------------------X--------B------------------------X------M--------M------------------M---X---------?--------------X------M?--------MX---------?---------------B----------X------B--
-X--------------X----X-----------------------------B--------B-----------------------E------o-------------------------------M------------?------------X----------o----------?----------------------------
-------------------------------X-----X----B----B---------X------------B-------------X-B--X------X--------------------------------------X---------------o---------------------------X--------------------
---o-----------------------------XM----------------------------------M-------------------X--------------------------o----------------------------o------------X-----------------B-----B-----------------
--------------M------?-----------------------------------X--------M-------------------------------------?----B----------------B--X----X------------M-o-----------------------------M--------------------
---------------------------------------X-----B--o----------------------?--M---X---?X-----------------------M---MMB----X--------------?---X---------?------------?B----------M---------------------------
-BX---------M----------M---------------------o---X--------------?------X----XX-------M------?B-B------------------M------X-----------M--------X------------------X--------------o----X-M---X-------B----
------XM----------X-----------------------------B-------?------------------------o---------------M-----------------------------------------------------------------------------------------------------v
------------------M-X------------------M-------------------------B-------M-------B--M--------------------------------Xo------------B---X----X------------------MX-------------------Bo-B---------------f
------X------?------------?------------------------------------------------X---------------------X----B---------------------X------------------------X------------X----X----X---------X---X--B---------f
-----------------?-------X-----------------------------------X------X---------------------------------------------BT--------------------------?-B--M--X------------------------------------------M-----f
----?----------X--------------------------?--X-----------B----------------------------------------?-------MB-------|------------------M-B------------B---?------------------------------------?--------f
-------------B---X-T-----------T-----B-----------M--------X-X---------------?-M--------X--------------B---------o--|-----------M-------------XX------------------M-----M------X----X-------------------f
---------XX-M------|----?------|------------M-------------------------X--------?B-------------------M--------------|-XM--------B-X------------------------------------------o----X-------B-------------f
m------------------|-----------|----X-----------------------------------------X-------------------X--X-------------|--------------------------oX------X------------------------------------------------X
XXX--XXXXXXXX-XXXXXX-XXXXXXXXXXXXXXXXXX--XXXXXX-X-XXXXXXXXXXXX-X--XXXXXXXXXX-XXXXXXXXXXXX-X-XXXXXX--X-XXXXXXXXXXXXXX-XX-XXXXXXXXXXX-XXXXXXXX-X-XXXXXXXX-X-XXX-XXXXX--X-XX-X-XXX-X-XXXXXX-XXXX-XX-XXX-X-X
