-----E-------E-?B-?----B--X--X-----------?-----------X---X-------------------M------------X----B----M-----M--------o-o--X----M---X---X---------------X------XB------B-------------B---X-M--X------------
-------------X----BM-X--M---B-M----X--MX-----X-------------X----B--------------o-------------B---o--------------?--------------B---B--------------------------B-B---X--MMB-X---M---------o----X-------X-
-------------X-------oB--X---X--X-----X---------MX--M------XX-----------------X---------X---------M------XX----------------------M-------B-----------X-------------------------------o----------------X-
-----?--M-----------X-------o---------------------------B------BM-------------M----------------B-X------B--BB-------------M-X----------o-------B------------------------------B---MX-------------X------
--------X-------X------B-X----X---------------B--------oo------------------X------M----B----------------X-------X--MBX-----o--------------M---o-------B------M---?----X------B--o-----------------------
--X----------B-B---------X---B-----------B-----o----------o--------?-------?--X---------X------M-----?-X-B------------BX-M----M---B----XX----X--o--M---------X--X--B----M--------------o-----o-?B-X---B-
---------------XX--XX------o--------M--B----M-----B?------X----X--B--o-----M-------?o----B----------M-M--------------M------?o-o-?-X---B---------------------X-----MX-Xo--X-M----X---BX----M-X-B---?B---
--------------X--M---------X--------?-----------M-o--?--------M----BMB----X----------B-------------------B-----------oB---------M---------------------?-----?-X--XB-o----------------------------B----Mv
-----B-?------------o----------?------BM--------------o--------B-----X-MM-X--------B---------X----B---------------------------X------o----X----B-X----------XBXM-----X----------M---B------------o---B-f
--X-----B---X------------?-M---B---X-M----------X-o----?B-------------MX-------X---X------B--M-----M-------B-------XM------B--X---------------X-----o---B----X-------o-----------BB-X------X-X-----o---f
----B-----X-----------------M-----------?--M--ME------------T---?---------------B?-----X-?-M--------------------M-----B------B---------X----------------B-------X--------X---?---X-o-------X-B--------Bf
------o----B---------X------------------MT-B---M---------------------------M-TX--B-BX---------MB-----------------------B-BB---X-------------X-------------B--o---M----------T-B?---X--M-------T--------f
------T-?-?X-o-X--M------X--------T-----------X-----B------B|o-------B--------XX--B---?----------o-----------------------?-------------M------------?----------X--X--B---?--TB---o--------------------of
--XXM-X----------------------------------|----o-----M?------|--o--B---X--B--X|X---------BX------B------E------------X--?-------------M--------B-X----?---M-----------o------|-----M-------M-MM|---?--oBf
m-----|------------o--------------|------|----------Xo-X----|--------------X---------------------------X--X-------X-X---------X-----o-------------------------X-------------|o--------X-------|-----o--X
XXXXXXXXXXXXXX-XXXXX-XXXXXXX-XX-XXXX-XXXXXXX-XX--XX-XXXXXXXXXX-XXX-XXXXXXXXXXX-X-XXXXXXX-XXXXXXXXXXXXXXXXXXXXXXXX-X-XXX-XXXX-XXXX-XXXXX-X-X-XXXXXXXXXXXX-XXX-X-XXXXX-X-XXXXXXX-XXXXXXX-XXXXXXXXXXXXX-XXX
