-------M----------------------B-M--B---B------oo--------B-------------------?M-----X---------------M---M----------M---X----o--------------------o---------B---------X----X-----------X----------X----M--
--B-------------B-------M------------------X-----M---------X-----X----------------?E---------B------X---------oM--------------------------------B-------X--o-------X-----E----o----------M--------------
--B---X--M----M--X--o---M--M-----o------?-----X---M--Bo---B---E-EM-?---?-----------X--------X-B---oB----?---X---?X-M-X----o--------------------------------------?M------B--------B----------B---?------
------------------B-------X----E---------X--------------------M-X---------M-B------------------X---B---B-------B------------o-B--------------------------Eo---oB----E-------------?--------BB-----------
-----------------B------------XMM----M----M------------------------X------------M-?---X------------------------M---------X----X-X-----------------X----------oX-M?--X---------------------------X-------
----X-------o-B-BB--------------?------E------X--X----o-----------B--------X-------M-----X------X?---M--------------o------M?----------?--------MX----M----M--X--X-X----?X-----?BB--------?----X--------
---M-----------o---------B-----------BB?----MB-X----E-----B-----B-B------------------X---------------------X--o--o----MX----M--M-X---Bo-X------------o-M-------------?--?--?------------------X-----X---
--X----o-o---B-X-----X--MX--B-?B---X-B--o---------B-M--X--------------------------M---------------o------------X-----B-o--E---------B---o--------------------------------B-----------o-------M-X-X-----v
--X----M----B----B---?-------M------------------B-----X---M----------X----------M--X----M---------------BX--------?---X---?---X---------------M----X---o----------------------X-M--?-------X---X-------f
-M------M---------------------X-----------o----BX-M---?X-M--X-----------------M------M------------?BB--------------------X-------X-X------------------B------o------X---?-E------M-------M-------------f
-B-M---X-----X?--X---------B------------X---X---B---M----------------------M-X---?-------M------------X--X----X----------X--M------------------------M------oB------------M--oMT-T--oX-------o---BX----f
-----??M--------X------X---B---M------X-oX---------------------------------------------------------M---?----X--------X-------------E--o------------------B-----B----------X----X----------------------Xf
-M--X--------------------B--B--------------------?----------------------M--?---?-----?------------------B---------M------------X?--M---X---------E------M----------------------|X|--X------------------f
----------------B------X------------?----oo---M--o----o------------------X-----------M----X-----------X---B------------X-----X--?-BX-------------X--------------------X--------|X|--------------------Bf
m----------oX------------X---o--------------------------------X------XX-----o---X---------------------------------X-------------X---------o----------------X------------XX----X|-|X------X-------------X
XXXXX-XXXX-XX-XX-XXX-XXXXXXXXXXXXXXXX-XXXXXX--XXXXXXXXXXXX-XXXXX-XXXXXXXXXXXXXX-XXXXXXXX-XXXXX-XXXX-X-XXX-XX--X-X-XXXX-X-XXXX-XXXXXXXXXXXX-XX-XXXX---XXXXXXXXX-XXXXXXXXXXXXXXXXXXX-XXXXXXXXXXXXXXXXX-XXX
