------------------X-------o-----------X-B---------B---B--B-----------?--o-XX-----------------B----BXX----------B-M-----------B-X----------------o--X-o--------------------------o-X--B---------?--------
-X-----------Mo-X-----B-B---------------?-------X-------------------B--------B--B--?-------X------------------X----------X------------------M------?-----B---X--------B----M-X-----------------o--------
---------B--------X---------o----------X---M-------M-M------?----------X------------o-B-Eo-----------------------B-M----M--X-BM-?------------XM---X--------X---------M---------MM----------B------------
-------------------------B------------?---------------BE-----------B-?X-o--------M-B---MX-----------X--X----o?--------X-------?B----X-B----------------M------M?---E----B-B------M---M?---X-------------
-B--------------------------B?--------------X-----?---MX-X-----X-----X-B--------B----M-----?------X-X-o-----------------X--------------------X-X--M-------X--------X--XXM-BX--o--BB-o---------oBM-----M-
---XB-------------B-X--MM-------------o------?-Xo-----M----o-------------B--------o------------B-------o------------?---------------------X-----MB-----o----------M-o---o------?------------------------
----X-------------B---X-X----------X--o?--B-X--BB---------------X--M---X---------X-X-X--------------------?---X-?--B--------------------X?---XX--X-?--M--X----B---------------X----------X--------M-----
-B---------------------X---B---------------------M---o---M------?---X----X--M-------o-----X--------oM----X---------------B----X-----------X---------o--------M----------------X------------o-B-----o---v
------M--------------------------B-----------X--XM---X-----B-X-----?---M--B----o--X-?-------X------------B-------B--o-------------------------XX------------B-----o------------X---?------------M----M-f
-------B-------------------M-------M--------?----M---B--M---------M-----X--o------------M-----?----??--X----------XB---X-X---o------o-M------------X-M-X----------MX------?-------X-------X------------f
--X--B-------X--------o----------B--MM?X-----------B-E-------------------------X--------------------T---B--M------?-B--E-------------o------X---------------------B---X-----o-------B-----XT----B------f
----T--o------?--------X---?X-----B-------M--??-M----X----------XX------------?--------B--------X-------o--------------B-----B------------------o-------M-MX--?-----------M-------B--X---------X-XB---Mf
------M------B----E-X------------E-----M--------------X----------X---B-------M---B-----X---------o--|--------Mo---------------------B------------B-B-------X----?-XX-B------T--------B-X---|--B--------f
------B--------X--M-M-X---?------?--B-------------BB-----------B-----X-X---------B------------------|--X----M----------X-------------B------X--X-----------BB------------------M--------BX-|-----------f
m---|-------------o----X----X-----------------------------------o-------o---------Xo----------------|--o----------------X----X----X--------------X----------X---------------|------------X-|--X--------X
XXXXX--XXXXXXXXXXXXXXX-XXXXXXX-X-X-X-X--XXXXXXXXXXXXXXXXXXXX-XXX-X-XX-XX--XXXXXXX-XXX-XXXXXXXXXXXXX-XXXXXXXXXXXXXXXXX-XXXXXXXXXXXXXX--X-XXXX-XXXXXX-XX-XXXXX-XXXXXXXX--XXXXXXX-XX-XX--XXXXX--XXXXXXXXXXX
