----------------------------------------------------------------------------------------------------B----------------------------------------------------------------------------------------------XX---
---------------------------------M-------------------------------------------------BX--o-------------------------------------------X---------------------X----------------------------------------------
---X---------------------------------------------?------------------------------------X------------------------M-------B------------------------X------o----------------------------------------B-------
-------X----------------------X----------X--------------X-------------------------------------------B------------o-------------------------?------------------------------------------------o-----------
-----------------------X---------------------X----M----------M-----X-------------------------------------------------B-----------------------------------M------------o-------------------------------o-
-----------------------------------o----------------------------------------X--------?-------------------X----------------------------------------X------------------------------------X----------------
------------------------------------------------------------X---------------------M-----------------------------B-------------------------------X-------------------------------------------------------
---------------M--XX----------------oM--------------------------X------------------------------M---------------------X-------------------?---------------------------------B---------------------------v
----------------X------B------------------------------------------X-------------o------------------------------o---X---------------------------------------------?-------------------------------------f
--------------------------------XB-----------------------------------------------------------------------------------------------------------------X----X--------B-------------------------------------f
----X-------------------------------------------------------------------------------M---------o-----------------------------------------------o----M---------------------------M-----------------------f
--------?----------?-------------------------------------B---M------------------------------B-------------------------------------------X-------------------------------------------X---------------T--f
--------------o------------o--------------------------------------------o---------X---------------------------X----------------------------------------------------M-------------------T------------|--f
-X-------M---------------------------------------------------X----------M----X---------------------------B------------M-------------------------------------------------------------B--|------------|--f
m----X---------------------------------------------------------------------X--o--------------------------------------------------------------------------------------------------------|------------|--X
XXXXXXXXX-X---XXXX-X-XXXXXX-XXXXX-XXXXXXXXXXXX-XX-XXXXX-X--XXXXXXXXXX-X-XX-XX--XXXXXXXXXXX-XXXXXXXXXXXXX-X-XXXXX-XXXXXXXXXX-XXXXX-XXXXXXXXXXX-XXXXXXXXXXXXXX---XX-XXX-XXX-X-X-XXXXXXX-XXXXX--XXXXXXXX-XX
