MB--------?--T-XX|-------X------B-?--E----T------o-M-B------------M-B-?---XoX-Bo-TX---M------MEM---|--?--TX----X-|----M-o?o-------|-X--|---Xo--?---X?----T?B---?---------X-----B---o-o-X-B-MX--E-oTo---T
o---Mo------E-X----M--T--B----------X---oB------o----o--B-X----X----o-o|?MX-X|------|B-M----o------E--B--BX-B-E--X-------?------B---T-----M---MB------?M--X-X--XXoo---B-----E-oo--------o-?o-------o-o-?
T-?-TEM--M---BT-----?-Bo---------?T---M-----X-|X-------------o-?|MX-oX-B--X--?--oM-Eo----BXB|X-----?-B--------o------?-EX---?---?------X---M--|EX---XB-----BX-------X--T----E-?--E--M--MB-|M------E|XB?E
------?-X----X------X---BME-?oX?--XMEMMX--B----X--M--o---X-EX-X-MM----?-o|-o--M--?BX-----Bo-------|----XB-X||---M-----EM---E?X-oXXB---oB-|-Eo?---o--|o--X-T--?-X--?-X--B|----T----?---Mo---XM-B-EXoM-?-?
---X?------B-Mo----TEBXX----?-Eo-B-o-XM------|---B-----M--MBX--|-----B-X-XB-T-----B----o--T?--B-X-------MXM------------------M--?--XX-M---E--------X--T------M|--XM-ET-----?|B-T|-E----?X?-M--?----TB--X
B?----M--TX-B|--T---MB--E---B----o-XTB--EB-M----|------?--o--XT-XM--E-----M?o--?|-BXEB-M----T--B---XX----------?---oBX---E--------X-XB--X-o---X--o----T--------E-B?X------BB-----o----EB-|-----X?o?-E--M
|-B--M-BT-----o--?X---?-EB----ME---o---E-oX------------ooM?M--------o-------B?-o-----E-T--X----ME---XB-B-E-X-------E-|-?XT---B-o-X|T-o--o-B-X-B---X|?-B-B---B--EM?--------|B-TM--X---oX----oX|------Xo-M
E?ME--B-----M---BEo-----?--o--X--?----EXo-T---E--MMTE-----------M--------B----E--B-----?--o-EX-T|-Mo-|---EM-||-X---?T?-X-----?--------o-?---M-X------B-?---E--?E--BM-T--B?--ME--MM-?--?---B------E---EBv
o---oX----X-------M?-------X----Xo--o--XEo----o-E-|-B?-XX--?-oX---------B-B-B------o--------ME--T-E-o-oM--|-------MT----BXE--B?-----E-?--B-o---o--?-?-M---------------??---B-X-------o--o---B-M--M-M--M?
--XX---XM----X----XB?-?B-----B----|-o---M-----X-XE-Mo------B--------?-?--M----?-----------EoXMX---o-X----oE-?----B---BEM-----??-T-X--o---XM----M-X--M-E-T------------o-----oX?--|-X---E---M--T---X-----o
X-|-o-X-??B-XX-?X---XB--------E-o----?----oBB--?BM---o-B-----MMTXXX---?T--B-B----M-BoB-Xo------X?T---XBME?-MB-oTXo|----M---|--?---MooM-T--M--M----T----X-------------X--X--X---XBB--X--?-------------BBo
|-?|----M----|----M----M----M-EBE---EMB--?-XMX-E-M-BE-?--?---------B---oM---X------B-?M-EoX-M----B----M--TT--T-------?-X?--BX-----?---T-X--B-T---B---BX-----X------|?-o-B---?----o--------E------o------
-TB------|-?-B-T?---BB---?XB-B--XE?-M-o-Bo-X---------B--M-?--XM?T|M-----?--EE-?---X-----B--X----B-?-|--------B-E-BX---o-X------E-B-----------------------|-X?---XB---X|BE---B----o--X-|XM--|--|---|--?M?
X?B?-X----TT------X--X---XT----T---M----M---------T-o|X|-X-BE-B----?|-?-----E-----?-o-----B-BB?---o-B----B---M---X-----X-BEX----X--oM|-X-------MX-T---XM---B?----------|----T---MXT-B------T-BM-----oTo|
m---------------X--|--X----|X---|XX-----X------------X--o--X-----|------E-E---------------X------o-------o--o----|X---------T---o-----T|-o-----------------o|-------EXo-Eo--------Eo---o-X---X--------oB
XXXXXXX-XX-XXXXXXXXXXXXXXXXXX-XX-XXXXXXXXXX-X--XXXXXX-XXXXXXXXXX-X-X-X-XXXX-XXXXXX-X-X-XXXXXXXXXXXXX-X-XXXXXX--XX-XXX-XXX-XXX-XXX-XXXXX-X---XX-XXXXXXX-XXXXXXX-XX-XXXXXXXXXXXXXXXXX-XXXX-XX-X-XXXXXXX-XX
