-----------------X------X------XM-------------------------------E-B------o-----------------o---------------------------?------------------X-------------------------------------------------------------
--------MX------------------------------------------------------M-----?o-----M-----M-------B------------?-----------------------X----------X------------------------------------X-------B---------------
----------------------------------?--------------M------------------X------------------------M-?----?------------X-----------------------------------------------X---------------------------M----------
--------------------------------X----BB-------------X----------------------------------------------M------------------------------------------------X----------------------------X-XB-------------------
------o------------X--------------B--------------B-----------------M-------------------------------------------------M-------------------------------------------M------------------------------o-------
-------------------------M----------o-----------------XM----------------------------------o-------------------------X----------B--------------B-------------------------------?-------------X-----------
----------------------------------B----------------------------------------X------------?-------------------------------------------------?-X---------X---------------------------------------?-X-------
---------------------------------------------------------X----------------------X-----------------------M-------B-----------X-----M------------?----------------X--------------M-----------------------v
------------------X------Bo---------X-------------B------?-----------------------------------?-X------------------------X-M-------------X------------E------------X--------------------X---------------f
-----------------------------------------X-----------------------o----------------------M---------------------------------?--------------------------B------X----------X--------B---?------B-----------f
-----------X---------------------------M------------------?--------------------------------------------?---------------------------------------------------------------------------------o---B---------f
----------------------M-------------------------------o-----B--------------E----------------------?----------------------------------------?---M-----------------------------X------------------M------f
----------------T-M-?---------------------X--------------------------------X---------------o-------------?---------------------------------------------X----------------o------------------------------f
----------B-----|------------------o-----------M-------------------------X--------------------------------B-----------M-B----X-----------------------X-----------------------------B--o--MM---------?--f
m---------------|--X------------------------------------------------------------------------------------------------------------------------------------------------------X---------X------o-----------X
XXXXXXXX--XXX-XXX-XXXXXXX-XXXXXXXX---XXXXXXXXXX-X-X-X-X-XXX-X-XXXXXX-XXXXXXXXXXXXXXXX-XX-XXXXX-XXXXXXXXXX-X-XXXXXX-X-XXXXXX-X-XXXXXXXX----XXXXXXXXXXXXXX--X--XXXXXXXX-XXX-XX-XXX-X--XX-XX-X-X----XXXX-XX
