T-----------o------------------------------X--------------------------------X--------o--------o---------------X--------------M-X---X---M----------------M---M-----------------------------------M------E
M---------------------------------X-----B--o---------------------------------X--M--------------X-------------------------------------------------X-----------------------------------------M-B-------XXE
E---------------------------------E-M----oM-------------B-----X-----?------------------------------------M-----------B---------------------------------B------------------------------?----------------T
?------X--------X---o--?----------?------------B----X---X-X-----------X----B----------MX--X----------------B-----------------------B---------X------M-----------------------------M--------B-------?---M
------------?-------------X------B------------------------------------------X------------B-----M------------------------------------------------------X----------X--------------B-----------------------
T----------?---XM-------X--------B----------------X-M--------B-X---------------------------E-----------------------X----?---------BX-------------------------------------o---------------------------B-T
X-------------B----------------------------X----------------o------------------------------X----B------X------------------------------------------o---------X--------------------------X---------------E
X----X---------------------------X-------M-----------------------------------------------X--------------X----------------------X-----------------------------------------------------------------------v
|------------------------------------------------------------M-M------o------------------------------------------------o----B------B--o--M-B-------B--M-o-------------------------X--------------------?
T-------------X-B---------------------------B-------------------?X-------B------------B-----------------------------o---------------------------B------------------------------------?-----------------o
B--------M-----------------------------------------------------X----------------------------------B---XM-----------B-------M-----------------M----------?-----------o-----------------------------------
M---oX-----M-X----?---------------B-B------------B----------------------------M----------------------------------------X---X---------------------------------------------------------------------o-----M
|----M-M----------------X-----------------------X-B---------------------------------------------------o------------------------------------------------------?-----------B--------------X---------------
X----------B--M-----------------------------------------------------------------B-------X--o------------------------------------------------o----------------------------T-----------------------------o
m----------------------------------------------------------------------------------------------------------------X---------X-----------------------------------------X---------------------------------T
XX-XX--XXXXXXXXXXXXXXXXXXXXXXXXXXXXX-X-XXX-XXXXXX-XXXXXXXXXXXXXXXXX-X-XXXX-XXXXXXX-XXXXX-XXX-X---XXX-XXXXX-XX-XXXXXX-XX-XXXXX-X-XXXX-X-XX-XX-XXX-XXXXX---XXXX-XXXXXXXXXXXXXXXXXXXXXXXXXX-X-XX-X----XXXXX
