-------X-|T-o-------XM--B-----M----------T|M--|-----Eo-----E--?X--M-o--T-B-T--T------|B--X-oM-XX------X------X-X--oMM--M-X--------?E---B--o---------M----X--E---|?---?-B-?B----|---B-T------|----M-X-X--
---B-----E--X--E----EB-X-B-E----?o-B----?----X--MX?o?--XoB--E-X--B---?-X-----B------------T--o---?--o-|-------X----------|---X--X|EX?M----?-oX?B--?-----o-----B------E-B----E-M-X--B---M----?M-----X----
--X?--|E-|------Bo-----------T--B------------|------BMB----XX----------T---M--T--?-----?--?---M---?T------X--MBo--|----|-----M-?--|-|--------------MoEB-?X--X---B--|-?--X--|-----BX-o-----X---?M----B---
-M-Bo--T-M-----Mo-------M------M-----o-|------X--X-------M-X|-ET--XE---BEB-------M--T-|---------------M---------------------B--------MXE|B--M-----X--------E-oXB--o--|--|--X-X-M--M?--T-------B-?---XX--
-Xo------X--E-?B-----E--B-M-------B-----B-X----M----E---o----?--?X-XT-E-X-X--------T----M------|-X?----E---X-X-X--BMM--|-o-B-?X---B-TX-?----T-BM-X----------T--X------M----X--X-B-oX--B---------??----X-
----X-X---M---|-X---BX------?o-----?--||?---|-------------E-B--M------?-|o-----X----E----M----o?----?-BM-----oX--T-E---o--|--|-XE----------X-B---M-o-------------X--X--XBT---B-X-E--------EX-o--XB----M-
-X---M-XMX-M------ToM---?--M---o------M------B-------|--M--BT-------T--B--oB---?--XM-MX-----B---?-B-B---X-?B-?--o-M|---X-Xo-----E----X--E-o--BX-o---------o-----?--B--M-------------o?-|o-oo-B----B|-|X-
-EoX-----T--BB?----?-M--E----|---X--?------?-M-M----T|--T----------?-----------------BE--X--M----M-E----------|X-TX-------------------|-BX---o----M---X----?-------X----XB--------BX-?-|----------?-ET-v
--M----X---E--------o---TM-----T----BB----BE-?M----X------o--o---o---------B----------E----B----------E--X--------B----?--M--oT---?-T-?--B-XB----B|X---?oo---MXB----o-X--------o--MX-o--X-----------X--f
--------BM-M?--------TX--T--T-B----?--------?M-------M---B-----ME---|-----XBB--|-|---------------E---o----|-M-X--B-------XoT-----------oo-M--B-------X-|--------?--T-----X-EE-------------X---Xo-------f
--B-o--B-------T--X---o---o-?-------B----BX-?--?-T---X-MB-----M---------MB--o--|------------?--------o--------oM-o-?---?--o-B---oX-----TE-T---X------------X-------??o----B-Eo----B-MBo-?----XE--------f
------?-oo---------BX----M--------X-o-----|-M--X--Xo--------?X----X-oEMX-X----------------B?-?--EB--BE-BT---T?-------B-?T--?---B--X---B-----oB----?-----X-------TX-----X?-o----|---T----T---------XT---f
----BBX--X--E------oo--M----------M--X---?o-M--------B---X----X-MM--B?----XB-MMo-|TX----------M--M-----o--o----E----?---X-T---Xo-EX-X-o------||--TTo---X--oB--M-?X----?---------?--|-T--------|E-B-M-?-f
-XB--------E-MX--------M-T---XMo-|----?-?B--X--XEB---B---E---X---B----MX--B---X-o--X------B-X------|------T?---T--XT----|-o---o---|----|----T--E-o----M?---|-B---o-------T--?M--B--|--|-o-X-X-X----M---f
mE---XT-----X----------E-------------|-o---------------------------X---------o--------X-----|---T-----o|E----T---X------E-T---------X----------X-o------------------------------T--|-|-XX--o-----X---X-X
XX-XX-XXXXX-XXXXX--XXXXXXX-XX-XXXXXXX-XXXXXXXXXX-XXX-XXXXXXX-XXXX-X-XXXXXXXXX-XXXXXXXXXXXXXXXX---XXXXXX-XXX-XXX-XXXXX-XX--XXXXXXXXXXXXXXXXX-XXXXXXXX-XXX---XXXX-XXX-X-XXXXXXXXXXXX-XXXXXX-XX-XXX-XX-XX-X
